localidad,tipo_ventas,ventas,tipo_gast,gasto_telecom,tipo_ganac,ganancia,mes,clima_prom,pobla_tot,pobla_tot_muj,pobla_tot_hom,pobla_meno_edad,meno_edad_muj,meno_edad_hom
1,3,185718000,1,26130.6,3,120533504,01/12/2022,16.1,863893,444725,419168,260350,128225,132125
2,2,32842000,3,23088.17,2,21320282,01/12/2022,16.1,31963,16433,15530,11390,5609,5781
3,1,20369000,3,37950.71,1,13213733,01/12/2022,14.5,63805,32406,31399,23397,11652,11745
4,1,18354000,3,26513.38,1,11902957,01/12/2022,16.1,21049,10874,10175,7097,3529,3568
5,1,8475000,3,217140.21,1,5485310,01/12/2022,13.9,32035,16367,15668,10989,5374,5615
6,3,383230000,1,22194.88,3,248846778,01/12/2022,15.7,854186,425977,428209,227917,112151,115766
7,3,677338000,1,24027.87,3,439731164,01/12/2022,14.1,1810645,899293,911352,503963,246971,256992
8,3,144148000,2,24708.56,3,93599499,01/12/2022,11.6,330652,167339,163313,86895,42903,43992
9,2,54840000,3,21116,2,35618523,01/12/2022,12.5,81059,40420,40639,23492,11470,12022
10,2,61638000,2,56724.99,2,40011714,01/12/2022,14,100660,49935,50725,28067,13772,14295
11,2,33548000,3,48491.61,2,21779570,01/12/2022,14,19081,9476,9605,5934,2909,3025
12,3,168468000,1,21474.85,3,109378176,01/12/2022,20.6,250141,126245,123896,65670,32312,33358
13,3,116841000,2,22278.56,3,75861843,01/12/2022,19.8,136285,66083,70202,42780,21001,21779
14,3,138773000,1,28976.9,3,90076035,01/12/2022,23.1,202694,98608,104086,64935,31858,33077
15,2,49896000,3,36466.81,2,32397098,01/12/2022,18.6,43805,22160,21645,13050,6507,6543
16,2,49913000,2,183196.36,2,32374239,01/12/2022,19.9,16311,8010,8301,4984,2435,2549
17,1,24329000,3,48845.94,1,15786695,01/12/2022,17.9,14357,6822,7535,3854,1925,1929
18,1,5725000,3,24766.49,1,3698549,01/12/2022,13.9,13596,6842,6754,4196,2086,2110
19,1,19704000,3,44779.53,1,12782478,01/12/2022,16.1,13596,6842,6754,4196,2086,2110
20,1,8793000,3,44984.92,1,5691610,01/12/2022,21,7185,3509,3676,2099,1015,1084
21,2,78856000,2,22744.59,2,51187439,01/12/2022,25.6,191238,97313,93925,52600,25862,26738
22,2,74685000,2,27490.83,2,48466436,01/12/2022,25.6,249623,130524,119099,66498,32635,33863
23,2,47696000,3,23598.28,2,30975547,01/12/2022,25.9,31375,16375,15000,10682,5317,5365
24,2,30412000,3,36102.75,2,19740505,01/12/2022,24.9,35799,18291,17508,11962,5883,6079
25,1,22815000,3,31586.1,1,14802969,01/12/2022,26,15949,8217,7732,4538,2234,2304
26,3,135492000,2,19721.57,3,87974305,01/12/2022,26.5,217550,113613,103937,65123,32048,33075
27,2,62620000,3,27689.94,2,40656452,01/12/2022,15.2,183509,96930,86579,60413,30246,30167
28,2,78048000,2,27827.55,2,50664562,01/12/2022,17.3,113479,60064,53415,36594,18199,18395
29,3,172658000,2,177145.98,3,112128785,01/12/2022,23.7,578830,303756,275074,166456,82025,84431
30,2,62403000,3,29908.94,2,40515376,01/12/2022,25.1,51797,27093,24704,17614,8812,8802
31,3,102639000,1,30695.34,3,66584903,01/12/2022,23.2,38087,20017,18070,11916,5833,6083
32,1,17024000,3,30516.55,1,11041874,01/12/2022,14.6,32109,16780,15329,10495,5074,5421
33,2,31485000,3,35314,2,20435738,01/12/2022,19.4,21727,11415,10312,7786,3890,3896
34,2,29179000,3,33051.37,2,18937541,01/12/2022,24.6,49201,25651,23550,16539,8102,8437
35,2,34901000,3,27951.11,2,22649445,01/12/2022,22.6,37546,19668,17878,11791,5836,5955
36,2,40462000,2,25570.59,2,26223727,01/12/2022,17,47688,25247,22441,17870,8920,8950
37,1,6300000,3,12190.91,1,4071523,01/12/2022,25.6,55931,28786,27145,18430,9082,9348
38,1,23724000,3,24587.55,1,15393716,01/12/2022,21,29018,15064,13954,10291,5191,5100
39,1,16484000,3,81544.07,1,10678149,01/12/2022,22.7,18219,9592,8627,5806,2838,2968
40,1,26555000,3,22101.53,1,17235024,01/12/2022,25.4,15244,8058,7186,4848,2429,2419
41,1,7643000,3,76505.8,1,4945412,01/12/2022,28.6,25366,13345,12021,7752,3823,3929
42,1,26221000,3,127446.69,1,17020018,01/12/2022,30,19271,9996,9275,6517,3095,3422
43,1,5629000,3,36784.78,1,3637899,01/12/2022,27.3,7662,4073,3589,2321,1153,1168
44,1,8816000,3,25883.28,1,5706885,01/12/2022,17.6,20044,10360,9684,7602,3787,3815
45,3,536498000,1,22386.76,3,348478649,01/12/2022,9.4,1501551,750157,751394,459910,225614,234296
46,3,212851000,1,21405.69,3,138158608,01/12/2022,12.4,925762,474776,450986,250961,123448,127513
47,2,54778000,2,22537.59,2,35551284,01/12/2022,14.3,128548,65838,62710,37721,18411,19310
48,2,51530000,3,23648.31,2,33450845,01/12/2022,11.8,135586,69677,65909,41627,20458,21169
49,2,63865000,2,28801.67,2,41445866,01/12/2022,14.5,113843,59214,54629,34117,16974,17143
50,1,9725000,3,24319.5,1,6298642,01/12/2022,18,23140,11693,11447,7155,3499,3656
51,1,17627000,3,169765.63,1,11432816,01/12/2022,12.5,35087,17902,17185,11563,5663,5900
52,1,25831000,3,56096.63,1,16755382,01/12/2022,12.9,42019,21548,20471,12599,6234,6365
53,1,18871000,3,54290.14,1,12235018,01/12/2022,12.8,22066,11231,10835,6719,3420,3299
54,1,16965000,3,28792.36,1,11001722,01/12/2022,8.7,17410,9121,8289,6393,3204,3189
55,1,3129000,3,29381.33,1,2011105,01/12/2022,12.7,22568,11549,11019,7200,3540,3660
56,1,11188000,3,29812.64,1,7248552,01/12/2022,8.7,15054,7516,7538,5557,2768,2789
57,1,7613000,2,28378.61,1,4877743,01/12/2022,10.5,8253,4210,4043,2801,1419,1382
58,1,9842000,3,22656.77,1,6374814,01/12/2022,7.1,7834,4065,3769,2439,1200,1239
59,1,3632000,3,28733.91,1,2339319,01/12/2022,4.3,14755,7617,7138,4907,2427,2480
60,1,26588000,3,26328.56,1,17253177,01/12/2022,10.1,62038,31762,30276,19262,9511,9751
61,3,190597000,1,179848.69,3,123763122,01/12/2022,18.3,690193,353744,336449,203574,99881,103693
62,3,273950000,1,22357,3,177880165,01/12/2022,14.5,864431,434753,429678,267728,131619,136109
63,2,89225000,2,71748.22,2,57914858,01/12/2022,15.9,237169,119538,117631,71348,35023,36325
64,2,90291000,2,38836.46,2,58618977,01/12/2022,14.4,173959,86825,87134,55826,27459,28367
65,1,22047000,3,22485.56,1,14305712,01/12/2022,13.9,39058,19755,19303,11201,5479,5722
66,3,205059000,1,27407.65,3,133108659,01/12/2022,18.2,59762,30506,29256,20025,9931,10094
67,1,28882000,3,87105.4,1,18734759,01/12/2022,17,49490,25496,23994,16916,8460,8456
68,2,50309000,2,66267.91,2,32645728,01/12/2022,14,160225,79799,80426,53549,26489,27060
69,2,29507000,3,5048.95,2,19157244,01/12/2022,14.5,114010,56192,57818,38156,18905,19251
70,2,48109000,3,126414.61,2,31233024,01/12/2022,17.4,75242,37695,37547,23792,11778,12014
71,1,25325000,3,34096.58,1,16436226,01/12/2022,13.7,59196,29915,29281,18125,8949,9176
72,2,30346000,3,35574.59,2,19700975,01/12/2022,16.4,32704,16713,15991,11320,5572,5748
73,1,13753000,3,18499.41,1,8913465,01/12/2022,13.9,23413,11884,11529,7157,3552,3605
74,1,19507000,3,22623.38,1,12653090,01/12/2022,15.1,38992,19602,19390,13022,6299,6723
75,1,2575000,3,955.52,1,1650563,01/12/2022,14.6,27314,13703,13611,9005,4397,4608
76,3,107786000,2,26780.73,3,69990002,01/12/2022,23.6,146965,75962,71003,46271,22786,23485
77,2,59420000,3,24044.57,2,38575514,01/12/2022,28.4,88337,44762,43575,34686,17254,17432
78,2,84757000,2,27143.13,2,55019914,01/12/2022,27.2,159853,80569,79284,57402,28064,29338
79,1,3976000,3,34767.7,1,2561732,01/12/2022,24.3,9746,4912,4834,3336,1602,1734
80,1,3300000,3,78813.99,1,2123594,01/12/2022,26.4,15368,7632,7736,5699,2779,2920
81,1,2516000,3,26328.56,1,1626116,01/12/2022,25,147496,76348,71148,49524,24280,25244
82,1,2034000,3,21272.67,1,1299195,01/12/2022,26,14892,7420,7472,5365,2615,2750
83,1,19311000,3,176215.46,1,12527637,01/12/2022,15.2,34798,17459,17339,10865,5211,5654
84,2,65893000,1,69501.21,2,42650601,01/12/2022,15.9,432205,227255,204950,86717,42372,44345
85,2,65329000,1,74141.56,2,42286704,01/12/2022,15.9,759003,398068,360935,168014,83097,84917
86,3,149937000,1,8676.29,3,97137215,01/12/2022,16.1,1173351,609477,563874,261635,129105,132530
87,2,41173000,2,23186.53,2,26700107,01/12/2022,16.3,414470,219003,195467,75588,37198,38390
88,1,26317000,2,37362.06,1,17050224,01/12/2022,13,186693,97615,89078,46165,22603,23562
89,3,263300000,1,55122.46,3,170749548,01/12/2022,15.8,1835486,947835,887651,451632,222341,229291
90,2,79649000,1,35301.68,2,51651222,01/12/2022,16.5,614447,325337,289110,113945,55951,57994
91,2,40249000,2,43655.3,2,26074745,01/12/2022,15.8,434153,232032,202121,62030,30612,31418
92,2,80310000,1,22667.87,2,52076359,01/12/2022,13.6,323771,167274,156497,83659,40990,42669
93,2,73138000,2,68960.84,2,47436300,01/12/2022,13.6,404695,212343,192352,85496,42058,43438
94,2,39872000,1,76309.93,2,25763700,01/12/2022,15.5,443704,233586,210118,95713,47173,48540
95,3,101086000,1,188068.14,3,65436396,01/12/2022,13.8,545884,284933,260951,101794,50260,51534
96,1,19232000,2,21480.59,1,12443612,01/12/2022,14,429481,220393,209088,105785,52018,53767
97,1,11784000,3,67748.13,1,7609422,01/12/2022,10.5,246428,128767,117661,58169,28791,29378
98,1,21174000,3,51566.29,1,13731978,01/12/2022,10.5,599935,314284,285651,130174,64060,66114
99,3,229473000,1,166730.59,3,149001520,01/12/2022,14.4,616068,317266,298802,191866,94056,97810
100,3,128036000,2,35327.06,3,83129857,01/12/2022,13.9,301742,154079,147663,97495,48007,49488
101,1,20512000,3,64856.75,1,13312826,01/12/2022,16.8,96243,49040,47203,29383,14345,15038
102,2,32387000,3,96142.59,2,21016504,01/12/2022,14.8,30063,15334,14729,10450,5151,5299
103,1,2449000,2,78449.83,1,1498998,01/12/2022,22.8,3222,1654,1568,1247,637,610
104,1,24361000,2,34496.35,1,15778462,01/12/2022,13.1,17967,9205,8762,6003,2945,3058
105,1,3907000,3,6510.08,1,2518277,01/12/2022,13.8,11943,6311,5632,3854,1993,1861
106,1,3124000,2,98833.17,1,1939109,01/12/2022,6.5,12850,6538,6312,4678,2267,2411
107,2,75170000,1,27295.38,2,48755497,01/12/2022,8,26678,13733,12945,10032,4897,5135
108,3,245849000,1,26960.57,3,159543614,01/12/2022,10.2,223876,119352,104524,50306,24928,25378
109,2,99127000,1,53405.54,2,64231802,01/12/2022,12.4,515353,266081,249272,126007,61695,64312
110,3,151603000,1,23476.83,3,98221706,01/12/2022,13.4,776220,402522,373698,193769,95439,98330
111,2,90725000,2,21550.96,2,58877129,01/12/2022,13,84298,43745,40553,23019,11356,11663
112,2,73823000,2,24786.66,2,47925225,01/12/2022,16.9,30929,15848,15081,8319,4034,4285
113,2,53603000,1,23088.56,2,34710859,01/12/2022,12.6,293245,152241,141004,70657,34731,35926
114,2,99253000,1,194541.63,2,64294715,01/12/2022,11.8,658907,338453,320454,150053,73914,76139
115,2,40444000,3,40554.55,2,26257546,01/12/2022,11.8,117995,60165,57830,29983,14851,15132
116,3,259404000,1,57286.24,3,168277505,01/12/2022,15.5,1643623,845932,797691,437489,216020,221469
117,3,116350000,1,161153.46,3,75467761,01/12/2022,16.2,368585,190133,178452,107535,52900,54635
118,2,71238000,2,23835.35,2,46239763,01/12/2022,7.9,174704,91497,83207,54449,28355,26094
119,2,29740000,3,37207.82,2,19281755,01/12/2022,5,2931,1520,1411,975,512,463
120,2,82689000,2,45696.32,2,53644097,01/12/2022,7.5,35491,18986,16505,7987,3993,3994
121,3,100470000,1,26847.88,3,65144347,01/12/2022,13,703215,359601,343614,230612,113552,117060
122,3,101883000,1,28809.34,3,66029639,01/12/2022,13.3,18226,9300,8926,5308,2603,2705
123,2,73518000,2,34308.43,2,47710185,01/12/2022,12.9,1072676,556998,515678,265425,131078,134347
124,1,28773000,3,131091.31,1,18681634,01/12/2022,18.5,14038,7254,6784,3763,1910,1853
125,3,105576000,2,32298.86,3,68525567,01/12/2022,7.9,174704,91497,83207,54449,28355,26094
126,2,76240000,3,24364.59,2,49523740,01/12/2022,22,7077,3593,3484,1748,893,855
127,2,59453000,2,144117.49,2,38590612,01/12/2022,12.9,53362,27304,26058,15169,7515,7654
128,1,23910000,3,27956.86,1,15517754,01/12/2022,3.9,24612,12254,12358,7339,3541,3798
129,2,72583000,1,41274.67,2,47009184,01/12/2022,13.7,10873,5623,5250,3757,1878,1879
130,2,78053000,2,70897.54,2,50678353,01/12/2022,12.2,23219,12339,10880,6425,3186,3239
131,2,37860000,3,42850.35,2,24575136,01/12/2022,13.1,12671,6512,6159,3454,1710,1744
132,1,28207000,3,66638.02,1,18304466,01/12/2022,10.5,30967,16277,14690,10756,5327,5429
133,2,64207000,2,40501.42,2,41678179,01/12/2022,16,323545,166328,157217,93932,46757,47175
134,1,7545000,3,45160.83,1,4885106,01/12/2022,20.6,19326,10155,9171,6252,3129,3123
135,2,31253000,3,22278.56,2,20283933,01/12/2022,7.9,33716,17686,16030,9317,4624,4693
136,1,19358000,3,16020.35,1,12533445,01/12/2022,12.3,40279,20716,19563,10282,5078,5204
137,1,4331000,3,22904.98,1,2792137,01/12/2022,13.3,29068,14916,14152,8580,4220,4360
138,2,38953000,2,91835.88,2,25262594,01/12/2022,14.3,12752,6694,6058,3471,1768,1703
139,1,6723000,3,8759.29,1,4321617,01/12/2022,10.8,33166,16973,16193,9497,4707,4790
140,1,7426000,3,33752.34,1,4811073,01/12/2022,11.8,52828,27143,25685,16500,8128,8372
141,2,45309000,3,17337.47,2,29423496,01/12/2022,22,32738,16941,15797,9059,4431,4628
142,1,15671000,3,43265.81,1,10160286,01/12/2022,13.3,30203,15792,14411,7568,3777,3791
143,2,52396000,3,29511.58,2,34019257,01/12/2022,11.8,11760,6069,5691,3432,1700,1732
144,1,16575000,3,51210.87,1,10752085,01/12/2022,12.9,72525,37076,35449,22128,10944,11184
145,1,10580000,3,120628.14,1,6851418,01/12/2022,5,18580,9729,8851,5724,2801,2923
146,1,28324000,3,4005.79,1,18380425,01/12/2022,13.3,24575,12798,11777,7126,3453,3673
147,1,1813000,3,25518.56,1,1158849,01/12/2022,12.6,44731,22925,21806,13335,6514,6821
148,1,14398000,2,63850.77,1,9304328,01/12/2022,12.5,658907,338453,320454,150053,73914,76139
149,1,18005000,3,55826.12,1,11678197,01/12/2022,15.5,10336,5387,4949,3449,1664,1785
150,1,25180000,3,269504.13,1,16346362,01/12/2022,6.3,4656,2421,2235,1533,751,782
151,1,10153000,3,25177.99,1,6568209,01/12/2022,16,9598,5002,4596,2910,1467,1443
152,1,16415000,3,31053.86,1,10647648,01/12/2022,11.8,15171,7853,7318,4470,2251,2219
153,1,7849000,3,200748.03,1,5078252,01/12/2022,13.3,10792,5577,5215,3492,1713,1779
154,1,3027000,3,107750.37,1,1963544,01/12/2022,11.8,37442,19141,18301,12089,5963,6126
155,1,4538000,3,12844.18,1,2927229,01/12/2022,7.9,17736,9182,8554,5577,2775,2802
156,1,12913000,3,25518.56,1,8380230,01/12/2022,13.3,386290,199249,187041,112223,55337,56886
157,1,13841000,3,161043.28,1,8966664,01/12/2022,13.3,9925,5218,4707,2833,1403,1430
158,1,10909000,3,27201.33,1,7066485,01/12/2022,18.5,6944,3666,3278,2341,1149,1192
159,1,9428000,3,36845.66,1,6099581,01/12/2022,12.4,88734,45471,43263,28316,14166,14150
160,1,12422000,3,292900.2,1,8052825,01/12/2022,7.5,6449,3346,3103,1687,833,854
161,1,9213000,3,22744.59,1,5966296,01/12/2022,10.2,10735,5576,5159,3010,1518,1492
162,1,3363000,3,54416.19,1,2164399,01/12/2022,7.5,10810,5614,5196,2941,1451,1490
163,1,1610000,3,37357.86,1,1045544,01/12/2022,22,13038,6614,6424,4157,2015,2142
164,1,11125000,3,155930.34,1,7226558,01/12/2022,13.3,22953,11862,11091,6973,3500,3473
165,3,292139000,1,26116.74,3,189670108,01/12/2022,17.3,1579803,804212,775591,594938,292494,302444
166,3,116588000,2,335094.84,3,75703750,01/12/2022,14.8,378143,194849,183294,128863,62806,66057
167,3,111761000,2,31916.6,3,72574663,01/12/2022,15.2,452090,230346,221744,162764,80177,82587
168,2,32437000,3,26401.66,2,21050298,01/12/2022,17.4,69371,35473,33898,25304,12303,13001
169,2,48787000,2,32435.47,2,31643460,01/12/2022,16.3,79772,40908,38864,30907,15312,15595
170,2,34842000,3,30296.58,2,22609349,01/12/2022,16.6,56597,29703,26894,19146,9514,9632
171,2,34088000,3,22278.56,2,22121370,01/12/2022,15.4,72663,38036,34627,27395,13712,13683
172,2,73990000,2,31624.59,2,48012420,01/12/2022,16.4,160682,83178,77504,52342,25860,26482
173,2,47308000,3,79668.64,2,30715539,01/12/2022,15.4,83352,42766,40586,32937,16375,16562
174,2,42753000,3,100603.71,2,27752092,01/12/2022,14,67101,35567,31534,27008,13393,13615
175,1,28518000,3,23264.59,1,18501359,01/12/2022,16.9,43249,22352,20897,17065,8284,8781
176,2,37201000,3,21502.36,2,24143164,01/12/2022,13.9,51894,27702,24192,20579,10113,10466
177,2,36039000,3,96701.14,2,23373413,01/12/2022,16.4,70068,36526,33542,21044,10402,10642
178,1,27674000,3,26852.73,1,17961137,01/12/2022,16.4,52156,27081,25075,17108,8394,8714
179,1,5631000,3,23678.59,1,3628451,01/12/2022,16.5,41910,21741,20169,12631,6146,6485
180,2,31203000,3,20586.67,2,20235882,01/12/2022,15,43998,23109,20889,17575,8775,8800
181,1,6531000,3,22499.84,1,4222664,01/12/2022,18.1,24757,12827,11930,9816,4898,4918
182,1,4397000,3,23342.77,1,2835770,01/12/2022,16.3,21756,11234,10522,8659,4317,4342
183,1,10049000,3,30325.97,1,6516750,01/12/2022,15,28109,14419,13690,10548,5187,5361
184,1,8628000,3,24746.13,1,5582681,01/12/2022,20,15305,7996,7309,5899,2872,3027
185,2,35918000,3,23924.63,2,23295399,01/12/2022,14.1,72452,38019,34433,23628,11618,12010
186,2,29725000,3,63861.41,2,19296502,01/12/2022,16.8,35401,18444,16957,12235,5945,6290
187,2,40937000,3,37825.5,2,26568695,01/12/2022,14.8,27593,14289,13304,10803,5260,5543
188,1,28771000,3,29512.46,1,18676562,01/12/2022,16.8,31264,16171,15093,9806,4840,4966
189,1,25738000,3,28702.46,1,16689199,01/12/2022,12.1,24228,12861,11367,9383,4674,4709
190,2,29463000,3,24793.98,2,19127397,01/12/2022,11.6,32831,17049,15782,13856,6706,7150
191,1,3907000,3,59094,1,2516903,01/12/2022,17.3,16092,8507,7585,6837,3451,3386
192,1,12212000,3,148470.1,1,7909592,01/12/2022,15.7,8011,4268,3743,3134,1562,1572
193,1,22221000,3,4437.17,1,14417519,01/12/2022,18.1,29002,14796,14206,11206,5550,5656
194,1,4442000,3,93543.04,1,2864362,01/12/2022,13.6,7946,4172,3774,3293,1607,1686
195,1,18626000,3,6599.11,1,12094709,01/12/2022,18.1,28260,14728,13532,11002,5473,5529
196,1,9355000,3,26630.42,1,6075301,01/12/2022,15.3,25845,13471,12374,9370,4627,4743
197,3,213413000,1,22700.63,3,138501310,01/12/2022,27.2,658609,345979,312630,183298,90145,93153
198,2,84918000,2,25527.7,2,55139414,01/12/2022,20.6,225728,119129,106599,71494,35347,36147
199,2,47743000,3,355360.32,2,30988974,01/12/2022,30,70760,36613,34147,21788,10705,11083
200,2,70686000,2,155066.57,2,45865268,01/12/2022,23.1,132854,69610,63244,41183,20301,20882
201,1,26979000,2,46983.87,1,17465209,01/12/2022,20.3,50399,26542,23857,14000,6918,7082
202,1,4702000,3,51937.2,1,3033308,01/12/2022,21.8,27944,14419,13525,9490,4664,4826
203,1,7301000,3,90890.66,1,4719767,01/12/2022,17.3,22534,11802,10732,7926,3939,3987
204,1,18667000,3,78696.88,1,12099588,01/12/2022,27.7,25148,13436,11712,8928,4476,4452
205,2,36021000,3,22485.56,2,23373095,01/12/2022,18.1,33783,18241,15542,12201,6089,6112
206,2,45994000,3,321835.11,2,29864514,01/12/2022,25.4,25850,13268,12582,8390,4048,4342
208,2,52324000,3,22402.56,2,33966988,01/12/2022,18.8,27607,14605,13002,9883,5002,4881
209,1,15607000,3,51542.77,1,10119031,01/12/2022,26,13866,7187,6679,4383,2099,2284
210,1,7455000,3,41254.5,1,4819167,01/12/2022,26,23363,12127,11236,7776,3818,3958
211,1,25017000,3,25217.47,1,16234721,01/12/2022,22.8,18224,9500,8724,7072,3514,3558
212,1,22481000,3,34984.09,1,14587187,01/12/2022,27.1,16447,8464,7983,4843,2381,2462
213,1,8916000,3,49358.38,1,5781229,01/12/2022,20.9,17550,9283,8267,5700,2861,2839
214,3,103064000,1,38142.64,3,66832042,01/12/2022,13.8,297848,156299,141549,74787,37046,37741
215,2,44897000,3,23855.65,2,29149308,01/12/2022,14.9,29390,15521,13869,7939,3942,3997
216,2,47447000,2,46488.83,2,30770650,01/12/2022,15.8,37608,20094,17514,11115,5490,5625
217,2,52113000,2,25551.11,2,33801188,01/12/2022,14.7,106163,56161,50002,30752,15034,15718
218,1,20600000,3,35154.82,1,13353844,01/12/2022,12.1,11149,5894,5255,2996,1479,1517
219,2,58016000,2,14171.16,2,37654015,01/12/2022,11.5,60265,30945,29320,18808,9224,9584
220,2,29802000,3,22153.53,2,19338673,01/12/2022,16,17718,9411,8307,4913,2492,2421
221,2,29042000,3,23725.93,2,18844695,01/12/2022,14.8,36618,19077,17541,10530,5273,5257
222,1,17914000,3,20591.36,1,11618549,01/12/2022,14.3,9853,5224,4629,2757,1390,1367
223,1,3292000,3,80631.51,1,2114131,01/12/2022,14.9,27713,14561,13152,7736,3885,3851
224,1,8372000,3,69986.62,1,5419521,01/12/2022,12.9,32276,17014,15262,9457,4578,4879
225,1,10790000,3,35412.36,1,6989178,01/12/2022,14.3,14689,7582,7107,4123,2033,2090
226,2,70923000,3,69900.05,2,46053461,01/12/2022,20.8,44311,23331,20980,13756,6771,6985
227,1,5435000,3,159738.53,1,3509273,01/12/2022,17.8,14732,7791,6941,4911,2433,2478
228,1,16617000,3,19144.31,1,10775872,01/12/2022,13.6,20530,10890,9640,6356,3180,3176
229,1,20561000,3,24105.56,1,13340406,01/12/2022,20.1,16368,8558,7810,4728,2323,2405
230,1,12441000,3,32259.6,1,8061941,01/12/2022,11.3,6213,3216,2997,1786,871,915
231,1,17138000,3,31772.11,1,11114129,01/12/2022,11.5,28792,15288,13504,8327,4111,4216
232,1,9309000,3,23502.56,1,6028615,01/12/2022,13.6,29472,15519,13953,9890,4934,4956
233,1,8151000,3,103399.58,1,5291513,01/12/2022,14.2,8657,4501,4156,2464,1200,1264
234,3,124145000,1,395451.77,3,80577453,01/12/2022,22.4,224166,112147,112019,65088,31954,33134
235,2,48288000,2,60449.29,2,31317730,01/12/2022,15.9,111569,57370,54199,36412,17892,18520
236,2,48150000,3,13573.03,2,31263661,01/12/2022,18,38780,20122,18658,13025,6461,6564
237,3,294384000,1,18910.89,3,190994240,01/12/2022,17.7,1385621,718628,666993,333198,164217,168981
238,3,196062000,1,22508.16,3,127187530,01/12/2022,16.3,1257547,645398,612149,321993,158559,163434
239,2,41672000,3,22424.57,2,27056105,01/12/2022,16.9,37871,19554,18317,11359,5732,5627
240,3,160305000,1,30993.82,3,103975136,01/12/2022,19.5,650123,329365,320758,200033,98558,101475
241,2,79017000,2,32372.75,2,51284740,01/12/2022,18.7,111975,57735,54240,31481,15460,16021
242,1,26003000,3,19152.37,1,16875326,01/12/2022,18,98842,50427,48415,30938,15263,15675
243,3,132608000,1,22280.08,3,86006345,01/12/2022,16.2,44103,22420,21683,15768,7755,8013
244,1,18968000,3,28207.59,1,12302449,01/12/2022,12.5,53539,27205,26334,18000,8916,9084
245,1,22573000,3,24027.87,1,14645602,01/12/2022,27,18787,9476,9311,6502,3270,3232
246,1,25788000,3,21278.78,1,16725415,01/12/2022,18,59648,30609,29039,19344,9536,9808
247,3,107359000,1,26116.79,3,69676141,01/12/2022,18.7,30471,15635,14836,9610,4654,4956
248,1,6315000,3,33863.53,1,4081073,01/12/2022,16.6,20286,10307,9979,6804,3413,3391
249,1,6880000,3,24734.47,1,4450339,01/12/2022,16.6,20345,10131,10214,6733,3300,3433
250,2,37294000,3,13694.82,2,24204845,01/12/2022,17.7,31115,15891,15224,10525,5240,5285
251,1,23642000,3,20852.83,1,15326025,01/12/2022,16.6,16550,8456,8094,5252,2552,2700
252,2,33045000,3,23677.17,2,21452289,01/12/2022,19.2,24352,12627,11725,8092,4062,4030
253,2,35522000,3,42633.4,2,23043555,01/12/2022,15,94978,48709,46269,29794,14672,15122
254,2,45192000,3,28774.5,2,29344987,01/12/2022,21.7,52019,26739,25280,15725,7759,7966
255,1,5450000,3,22393.69,1,3516171,01/12/2022,16.6,24580,12765,11815,8215,4057,4158
256,1,21965000,3,25174.59,1,14248458,01/12/2022,19,28678,14679,13999,9074,4497,4577
257,1,5798000,3,12386.19,1,3746421,01/12/2022,13.6,22738,11719,11019,7000,3537,3463
258,1,20374000,3,27883.76,1,13218067,01/12/2022,18.7,28145,14670,13475,8863,4390,4473
259,1,18289000,3,47254.78,1,11865257,01/12/2022,18.7,19113,9852,9261,5504,2716,2788
260,1,3141000,3,22470.94,1,2019601,01/12/2022,12.5,25925,13382,12543,8585,4189,4396
261,1,1293000,3,46067.98,1,818255,01/12/2022,19,13033,6697,6336,4420,2181,2239
262,1,4975000,3,14407.35,1,3211538,01/12/2022,8,5955,3118,2837,1972,974,998
263,1,2538000,3,33839.44,1,1631942,01/12/2022,17.7,8850,4524,4326,2773,1377,1396
264,1,3895000,3,32788.55,1,2511287,01/12/2022,13.6,9529,4943,4586,3018,1490,1528
265,1,17380000,3,22259.12,1,11267643,01/12/2022,12.5,14636,7533,7103,4910,2424,2486
266,2,33708000,3,126023.61,2,21876832,01/12/2022,16.6,40906,20800,20106,12864,6409,6455
267,1,10694000,3,46273.85,1,6926572,01/12/2022,18.7,8142,4289,3853,2686,1333,1353
268,1,3617000,3,38942.97,1,2328791,01/12/2022,13.6,7954,4060,3894,2570,1274,1296
269,1,21604000,3,69469.72,1,14017834,01/12/2022,17.7,17000,8527,8473,5215,2549,2666
270,1,5466000,3,28679.7,1,3530597,01/12/2022,14.1,14424,7439,6985,5399,2678,2721
271,1,3617000,3,87927.55,1,2328877,01/12/2022,17.7,16873,8725,8148,6022,3008,3014
272,1,4185000,3,220242.03,1,2702293,01/12/2022,18.7,5109,2618,2491,1631,805,826
273,1,3539000,3,19973.72,1,2277856,01/12/2022,18.7,13243,6795,6448,4043,1954,2089
274,1,4471000,3,34650.77,1,2883871,01/12/2022,12.5,14497,7627,6870,4260,2099,2161
275,1,4085000,3,48332.56,1,2636167,01/12/2022,17.9,16324,8373,7951,5562,2774,2788
276,1,8222000,3,24086.04,1,5321382,01/12/2022,25.6,9842,5047,4795,3323,1629,1694
277,1,4565000,3,38273.49,1,2945748,01/12/2022,12.5,27833,14525,13308,9097,4581,4516
278,1,8585000,3,48880.46,1,5574998,01/12/2022,18.3,33284,17172,16112,10804,5349,5455
279,1,3758000,3,69210.5,1,2420200,01/12/2022,22.5,14697,7601,7096,4740,2380,2360
280,1,7507000,3,161509.95,1,4860398,01/12/2022,15,18607,9363,9244,6403,3178,3225
281,1,5983000,3,94120.66,1,3860216,01/12/2022,12.5,13810,7082,6728,4665,2327,2338
282,1,4880000,3,40413.8,1,3159614,01/12/2022,18.3,9626,4835,4791,3007,1492,1515
283,1,3013000,3,22172.87,1,1937334,01/12/2022,16.6,11110,5642,5468,3479,1704,1775
284,3,150074000,1,50178.33,3,97385019,01/12/2022,14.4,743275,388114,355161,202467,99875,102592
285,2,60554000,2,23108.38,2,39265851,01/12/2022,16.1,154546,80401,74145,48513,24003,24510
286,3,100046000,1,20607.43,3,64899212,01/12/2022,16.8,299523,155411,144112,93845,46362,47483
287,2,74282000,2,22647.05,2,48195372,01/12/2022,26.6,83637,42325,41312,24783,12286,12497
288,2,49542000,2,72135.5,2,32120756,01/12/2022,26,102362,52461,49901,35162,17416,17746
289,1,25230000,3,23631.87,1,16365503,01/12/2022,13.7,55287,28877,26410,16959,8447,8512
290,2,33052000,3,23898.56,2,21444857,01/12/2022,18.6,87042,45232,41810,26414,12958,13456
291,2,53290000,2,11337.49,2,34576168,01/12/2022,9,86901,45620,41281,26262,13160,13102
292,2,29170000,3,64257.48,2,18936945,01/12/2022,16.3,30519,15931,14588,10809,5325,5484
293,2,43696000,2,179690.92,2,28344457,01/12/2022,13.7,60811,31893,28918,19713,9706,10007
294,1,4042000,3,75891.38,1,2613727,01/12/2022,13.2,61510,31765,29745,21000,10487,10513
295,2,30320000,3,28335.73,2,19657662,01/12/2022,17.5,70042,36241,33801,21818,10809,11009
296,1,6295000,3,24528.01,1,4078055,01/12/2022,19.2,24662,12965,11697,6937,3350,3587
297,1,8107000,3,170383.83,1,5248342,01/12/2022,13.2,15414,7999,7415,4635,2291,2344
298,2,33730000,3,25800.6,2,21902097,01/12/2022,14.4,71528,37497,34031,23278,11539,11739
299,1,2644000,3,19600.56,1,1696551,01/12/2022,16.3,15249,7932,7317,4894,2453,2441
300,2,39934000,3,22608.11,2,25933201,01/12/2022,15.7,39425,20578,18847,13203,6477,6726
301,1,4960000,3,252724.31,1,3202065,01/12/2022,19.2,17293,8766,8527,5650,2795,2855
302,1,18420000,3,25863.58,1,11949911,01/12/2022,9,16905,8772,8133,5514,2740,2774
303,1,5061000,3,252721.65,1,3267263,01/12/2022,13.7,18097,9360,8737,5881,2892,2989
304,1,19102000,3,32386.61,1,12392401,01/12/2022,17.3,32333,16690,15643,10314,5057,5257
305,1,26021000,3,29602.36,1,16888464,01/12/2022,15.8,49940,25545,24395,16071,7998,8073
306,1,23571000,3,25117.61,1,15293089,01/12/2022,15.7,1049,546,503,282,149,133
307,1,20464000,3,62343.3,1,13272841,01/12/2022,16.7,6853,3584,3269,2311,1149,1162
308,1,10858000,3,55397.41,1,7052651,01/12/2022,24.8,12262,6119,6143,4251,2104,2147
309,1,4533000,3,36155.64,1,2917779,01/12/2022,15.8,11086,5609,5477,3615,1780,1835
310,1,5043000,3,30609.94,1,3250141,01/12/2022,18.6,13821,7083,6738,3938,1966,1972
311,2,75845000,1,25668.58,2,49138207,01/12/2022,20.7,341029,180370,160659,82444,40670,41774
312,3,100579000,1,21632.53,3,65268600,01/12/2022,19.3,157336,82380,74956,43883,21497,22386
313,2,35020000,3,28384.59,2,22742147,01/12/2022,22.9,174629,91268,83361,46521,22880,23641
314,2,47131000,2,21990.36,2,30582438,01/12/2022,21.7,104461,54150,50311,30967,15315,15652
315,1,21669000,3,81391.86,1,14035523,01/12/2022,18.7,44353,23038,21315,13070,6400,6670
316,1,6321000,3,46946.51,1,4083852,01/12/2022,22.3,21375,11206,10169,5662,2753,2909
317,2,48930000,3,258299.34,2,31761867,01/12/2022,23.2,17777,9225,8552,4254,2086,2168
318,2,68216000,2,163081.06,2,44239796,01/12/2022,22.9,64084,32934,31150,19785,9668,10117
319,1,22358000,3,31699.41,1,14509188,01/12/2022,21.4,20434,10867,9567,5939,2970,2969
320,1,19271000,3,21828.9,1,12497771,01/12/2022,16.4,19085,9763,9322,6343,3119,3224
321,3,181860000,1,28060.79,3,118089916,01/12/2022,17.8,371387,192530,178857,106784,52432,54352
322,2,38658000,3,26459.74,2,25106505,01/12/2022,23,18023,9240,8783,5154,2503,2651
323,1,26895000,3,22048.87,1,17436589,01/12/2022,19.9,20322,10479,9843,6201,3025,3176
324,2,36409000,3,24226.07,2,23634078,01/12/2022,19.9,25477,13300,12177,8208,4059,4149
325,1,16381000,2,19643.81,1,10590866,01/12/2022,23,13620,7015,6605,4098,1994,2104
326,1,22752000,3,25053.38,1,14763175,01/12/2022,19.9,48170,25016,23154,15515,7657,7858
327,1,15165000,3,30282.01,1,9810976,01/12/2022,23.6,10593,5340,5253,3485,1705,1780
328,2,62239000,2,11451.4,2,40383602,01/12/2022,23,8730,4395,4335,2894,1447,1447
329,1,7441000,3,320244.08,1,4813602,01/12/2022,23.6,14678,7367,7311,4863,2405,2458
330,1,13710000,3,52120.43,1,8885771,01/12/2022,23,10935,5450,5485,3532,1706,1826
331,1,20643000,3,75771.25,1,13391437,01/12/2022,23.7,19976,10345,9631,6431,3120,3311
332,3,117098000,2,76515.26,3,76009251,01/12/2022,18.9,412199,209241,202958,82879,40585,42294
333,3,111367000,1,56371.42,3,72266747,01/12/2022,16.6,304052,152635,151417,84118,41457,42661
334,3,162227000,1,123009.31,3,105320103,01/12/2022,15.3,536436,267279,269157,158598,77797,80801
335,3,210871000,1,29023.4,3,136911083,01/12/2022,15.3,635862,320627,315235,153834,75737,78097
336,3,267569000,1,74300.54,3,173661551,01/12/2022,17.6,1142952,578172,564780,270109,132170,137939
338,2,30675000,3,236124.21,2,19903175,01/12/2022,15.3,75721,38037,37684,21903,10795,11108
339,2,37701000,3,23974.41,2,24467377,01/12/2022,17.8,70378,35870,34508,21367,10464,10903
340,2,81162000,3,45744.62,2,52727416,01/12/2022,12.7,308285,152976,155309,108145,53196,54949
342,2,80298000,2,31132.46,2,52134606,01/12/2022,15,234698,115478,119220,87040,43098,43942
343,1,24130000,3,24470.59,1,15657009,01/12/2022,15.3,28843,14318,14525,8529,4190,4339
344,1,22294000,3,13219.91,1,14466735,01/12/2022,17.1,33522,17126,16396,9330,4711,4619
345,2,30805000,3,22303.08,2,19976303,01/12/2022,15.9,54467,27606,26861,15858,7789,8069
346,2,29562000,3,24733.56,2,19194425,01/12/2022,18.9,13059,6525,6534,4137,2073,2064
347,1,2748000,3,21974.5,1,1781763,01/12/2022,12.7,9934,4952,4982,3082,1558,1524
348,1,11363000,3,43612.03,1,7361156,01/12/2022,12.7,7844,4131,3713,2621,1355,1266
349,1,17564000,3,103209.72,1,11369032,01/12/2022,15.3,48069,23121,24948,16392,8040,8352
350,1,22008000,3,29985.59,1,14278798,01/12/2022,16.6,11583,5810,5773,3713,1872,1841
351,1,3827000,3,28168.61,1,2466484,01/12/2022,25.3,29903,15539,14364,9778,4798,4980
352,3,192514000,1,25581.84,3,124897976,01/12/2022,20.3,258913,138803,120110,68042,33683,34359
353,2,85207000,2,23439.68,2,55300076,01/12/2022,23.2,103609,54904,48705,31555,15575,15980
354,2,50218000,2,159557.72,2,32567495,01/12/2022,28.2,76660,40113,36547,21596,10646,10950
355,2,62678000,3,46573.51,2,40693445,01/12/2022,27.1,88280,46038,42242,25864,12608,13256
356,2,41964000,3,28373.66,2,27225057,01/12/2022,17.7,56163,29689,26474,18214,8872,9342
357,1,3557000,3,29855.93,1,2283577,01/12/2022,23.2,7263,3837,3426,2540,1279,1261
358,1,22350000,3,49653.46,1,14503526,01/12/2022,26.1,16645,8759,7886,5075,2484,2591
359,1,21134000,3,23217.87,1,13688220,01/12/2022,21.9,31469,16729,14740,9837,4899,4938
360,1,18773000,3,66383.52,1,12175975,01/12/2022,13,12729,6935,5794,4541,2296,2245
361,1,21820000,3,24513.39,1,14158894,01/12/2022,27.1,26015,13735,12280,7360,3633,3727
362,2,60337000,3,22514.9,2,39184234,01/12/2022,25.3,29903,15539,14364,9778,4798,4980
363,2,35507000,3,23520.56,2,23040714,01/12/2022,26.8,10504,5405,5099,3440,1722,1718
364,1,27987000,3,57942.53,1,18167394,01/12/2022,28.2,45134,23442,21692,13494,6690,6804
365,2,31748000,3,23433.58,2,20603813,01/12/2022,17.7,29130,15431,13699,9957,5019,4938
366,1,6434000,3,35341.11,1,4162266,01/12/2022,22.9,5812,3105,2707,1767,906,861
367,1,20714000,3,24760.59,1,13435298,01/12/2022,13,15851,8463,7388,5625,2839,2786
368,1,5874000,3,47568.17,1,3781494,01/12/2022,17.7,15298,8185,7113,4499,2268,2231
369,2,41539000,3,26582.77,2,26972014,01/12/2022,27.1,17525,9370,8155,5075,2488,2587
370,1,27237000,2,25725.56,1,17633902,01/12/2022,13,18915,10248,8667,6395,3217,3178
371,1,28106000,3,70172.5,1,18247073,01/12/2022,18.9,81848,43535,38313,23849,11894,11955
372,2,54629000,3,36451.42,2,35465616,01/12/2022,18.3,33726,17513,16213,11096,5372,5724
373,1,3084000,3,76527.55,1,1972683,01/12/2022,17.7,11168,5931,5237,3889,1954,1935
374,1,7944000,3,14132.08,1,5138891,01/12/2022,23.2,6341,3343,2998,2049,979,1070
375,2,29372000,3,29356.74,2,19071735,01/12/2022,18.9,45895,23816,22079,12162,5997,6165
376,1,9799000,3,129130.16,1,6346842,01/12/2022,22.5,6863,3664,3199,2612,1321,1291
377,1,15794000,3,32627.21,1,10237212,01/12/2022,18.3,10611,5602,5009,3876,1871,2005
378,1,4526000,3,116797.4,1,2920195,01/12/2022,26.1,14226,7514,6712,4380,2214,2166
379,1,7638000,3,455965.14,1,4941003,01/12/2022,18.9,7997,4114,3883,2359,1161,1198
380,1,5364000,3,23511.6,1,3475263,01/12/2022,21.9,4188,2243,1945,1509,761,748
381,2,44709000,2,34815.73,2,29004023,01/12/2022,25.3,15373,8115,7258,5203,2638,2565
382,1,23696000,3,21065.67,1,15372991,01/12/2022,27.5,14071,7408,6663,4497,2251,2246
383,1,2448000,3,31811.58,1,1570615,01/12/2022,12.2,6642,3720,2922,2058,1005,1053
384,1,12222000,3,29875.69,1,7937790,01/12/2022,24.9,11054,5638,5416,3563,1745,1818
385,3,332615000,1,27809.49,3,215743785,01/12/2022,14.1,1542232,806262,735970,402209,198130,204079
386,2,68121000,2,23898.56,2,44208254,01/12/2022,12.9,78264,40929,37335,23163,11368,11795
387,2,94511000,2,26474.87,2,61329774,01/12/2022,19.2,293825,155300,138525,93203,46206,46997
388,2,41458000,2,252964.42,2,26887251,01/12/2022,21.7,49578,26095,23483,16381,8171,8210
389,2,54015000,2,22048.87,2,35055460,01/12/2022,16.9,89314,47398,41916,25892,12760,13132
390,2,63551000,3,20867.43,2,41261110,01/12/2022,14.4,31315,16320,14995,10348,5100,5248
391,1,26640000,3,22305.76,1,17269457,01/12/2022,10.3,39203,20881,18322,12964,6446,6518
392,2,30259000,3,26883.65,2,19618992,01/12/2022,15.3,58957,31503,27454,19229,9506,9723
393,2,49423000,2,25185.73,2,32035971,01/12/2022,13.2,62849,33939,28910,17954,8876,9078
394,1,27584000,3,200613.37,1,17894273,01/12/2022,12.3,25468,13582,11886,8293,4136,4157
395,2,30052000,2,27017.55,2,19477075,01/12/2022,10.3,31599,16595,15004,11708,5967,5741
396,2,40287000,3,22858.87,2,26140294,01/12/2022,10.3,29123,15247,13876,9589,4733,4856
397,1,24619000,3,25863.58,1,15978264,01/12/2022,11.5,18110,9443,8667,6325,3046,3279
398,1,15353000,3,34552.84,1,9934670,01/12/2022,10.3,31695,16422,15273,11280,5582,5698
399,1,24883000,3,56827.1,1,16138636,01/12/2022,10.3,95322,48884,46438,32521,16133,16388
400,1,23019000,3,47265.51,1,14937701,01/12/2022,10.3,9358,5013,4345,2738,1323,1415
401,1,17247000,3,22485.56,1,11158843,01/12/2022,12.2,9149,4948,4201,2691,1357,1334
402,1,5124000,3,52986.24,1,3308551,01/12/2022,10.3,9913,5282,4631,3496,1711,1785
403,1,16610000,3,23048.27,1,10783656,01/12/2022,10.3,36620,18819,17801,10303,4961,5342
404,1,2277000,3,25024.42,1,1458389,01/12/2022,10.3,5276,2719,2557,1830,893,937
405,1,26535000,3,24364.59,1,17224661,01/12/2022,10.3,41455,21994,19461,13993,6843,7150
406,1,23061000,3,50337.85,1,14965794,01/12/2022,13.7,29613,15403,14210,9414,4672,4742
408,1,16670000,3,74205.3,1,10812412,01/12/2022,13.7,13922,7166,6756,5211,2590,2621
409,1,9380000,3,20874.6,1,6076133,01/12/2022,10.3,10960,5789,5171,3556,1785,1771
410,1,18419000,3,187334.63,1,11949261,01/12/2022,9.9,22904,12086,10818,7644,3743,3901
411,1,10153000,3,24748.03,1,6574663,01/12/2022,10.3,11776,6077,5699,3730,1832,1898
412,1,2437000,3,25728.81,1,1575291,01/12/2022,10.3,16797,8560,8237,5425,2652,2773
413,1,4533000,3,25984.59,1,2923803,01/12/2022,10.3,19648,10052,9596,6751,3334,3417
414,1,21828000,3,22937.73,1,14164172,01/12/2022,20.2,19341,10302,9039,6428,3158,3270
415,1,3882000,3,23552.88,1,2500441,01/12/2022,12.1,11487,6208,5279,3749,1855,1894
416,1,6633000,3,19634.91,1,4294345,01/12/2022,10.3,5703,2985,2718,1959,971,988
417,1,2228000,3,24247.86,1,1428211,01/12/2022,10.3,6644,3435,3209,2305,1130,1175
418,1,4275000,3,17956.62,1,2754430,01/12/2022,10.3,7491,3982,3509,2583,1266,1317
419,1,2661000,3,21454.84,1,1715599,01/12/2022,10.3,8481,4360,4121,2849,1391,1458
420,2,31700000,3,40355.41,2,20567792,01/12/2022,14.3,46996,24240,22756,12187,6012,6175
421,1,3821000,3,84806.7,1,2463063,01/12/2022,16.9,8445,4468,3977,3005,1505,1500
422,1,9083000,3,21660.94,1,5880614,01/12/2022,14,5612,3027,2585,1851,938,913
423,1,10944000,3,161224.5,1,7089352,01/12/2022,21.3,5276,2719,2557,1830,893,937
424,3,278012000,1,64427.79,3,180454836,01/12/2022,13.2,794789,407239,387550,199480,98049,101431
425,2,68838000,2,17757.6,2,44677914,01/12/2022,14.8,177719,91525,86194,50219,24680,25539
426,2,29291000,3,28618.61,2,19012665,01/12/2022,14.8,34955,18206,16749,9854,4805,5049
427,1,2906000,3,51300.89,1,1865696,01/12/2022,13,115264,60166,55098,28758,14392,14366
428,1,22497000,3,22048.87,1,14599707,01/12/2022,14.8,16795,8697,8098,5436,2628,2808
429,1,8062000,3,28472.77,1,5216866,01/12/2022,16.1,13390,6831,6559,4033,1966,2067
430,1,16349000,3,18943.18,1,10596941,01/12/2022,16.8,7953,4224,3729,2375,1195,1180
431,1,10743000,3,29409.02,1,6964451,01/12/2022,21.4,15512,8121,7391,5093,2493,2600
432,3,102580000,2,22651.46,3,66623594,01/12/2022,25.8,169028,86790,82238,45879,22689,23190
433,3,252947000,1,22647.05,3,164239335,01/12/2022,24.7,888797,441181,447616,247410,121384,126026
434,3,109517000,2,38173.36,3,71109522,01/12/2022,24.6,304942,149380,155562,85665,42398,43267
435,2,43703000,2,121802.63,2,28343099,01/12/2022,25.2,84519,42292,42227,24955,12440,12515
436,2,31875000,3,20065.47,2,20688424,01/12/2022,24.9,30754,15948,14806,10320,5221,5099
437,3,255735000,1,27737.74,3,166066525,01/12/2022,15,845941,437370,408571,227808,112567,115241
438,3,100891000,2,26099.75,3,65514293,01/12/2022,20.4,136351,71718,64633,38918,19062,19856
439,2,52551000,2,21194.91,2,34082259,01/12/2022,16.2,86686,44901,41785,27406,13467,13939
440,2,53957000,3,28887.87,2,35024784,01/12/2022,18.8,58158,30570,27588,17715,8934,8781
441,2,46865000,2,35045.83,2,30400195,01/12/2022,22.2,24258,12834,11424,7258,3602,3656
442,1,21816000,3,43233.69,1,14154283,01/12/2022,20.5,24454,12691,11763,7326,3576,3750
443,2,41855000,3,56856.47,2,27176556,01/12/2022,14.4,310192,159130,151062,94872,46787,48085
444,1,4140000,3,50724.92,1,2663262,01/12/2022,15.9,14340,7646,6694,4731,2430,2301
445,2,99330000,2,25033.11,2,64490358,01/12/2022,20.5,15341,8078,7263,4842,2416,2426
446,1,6822000,3,34660.75,1,4411643,01/12/2022,22.2,8045,4283,3762,2501,1247,1254
447,1,18750000,3,22278.56,1,12162662,01/12/2022,22.2,6644,3540,3104,2086,1058,1028
448,1,5735000,3,61291.23,1,3705904,01/12/2022,20.5,16582,8647,7935,5030,2477,2553
449,2,51348000,2,46548.38,2,33300429,01/12/2022,23.1,30796,15740,15056,9239,4503,4736
450,3,129473000,2,68090.02,3,84066559,01/12/2022,20.8,77849,40866,36983,21990,10871,11119
451,2,66244000,3,26751.38,2,43011616,01/12/2022,21,65215,33971,31244,19700,9733,9967
452,3,238840000,1,66786.36,3,155075616,01/12/2022,20.9,441975,227109,214866,122010,60145,61865
453,3,856163000,1,37485.53,3,556213050,01/12/2022,24,808416,416251,392165,234633,115277,119356
454,3,166540000,1,70395.76,3,108089490,01/12/2022,20.4,298009,154344,143665,83869,41238,42631
455,2,32595000,3,104449.08,2,21163071,01/12/2022,24,33924,17240,16684,10629,5267,5362
456,1,22695000,3,38540.77,1,14719315,01/12/2022,20.2,14772,7516,7256,4444,2199,2245
457,2,39559000,3,49245.03,2,25680561,01/12/2022,20,19742,9908,9834,6831,3367,3464
458,1,25701000,3,22858.87,1,16675353,01/12/2022,19.7,12848,6693,6155,3711,1831,1880
459,1,20045000,3,29193.99,1,13001299,01/12/2022,19.6,5457,2839,2618,1473,755,718
460,1,13238000,3,47011.21,1,8576315,01/12/2022,19.5,5926,3043,2883,1700,842,858
461,1,23993000,3,23238.47,1,15563825,01/12/2022,24,17097,8801,8296,5359,2662,2697
462,1,27371000,3,15740.88,1,17739939,01/12/2022,23.1,28239,14113,14126,8795,4312,4483
463,1,23833000,3,27155.33,1,15468457,01/12/2022,21.9,16934,8502,8432,5395,2626,2769
464,1,28428000,3,23554.59,1,18429354,01/12/2022,19.3,11851,5973,5878,3739,1841,1898
465,1,8929000,3,33367.93,1,5775148,01/12/2022,20.3,25157,12582,12575,8765,4230,4535
466,1,5862000,3,22593.05,1,3788667,01/12/2022,20,6055,3107,2948,1652,803,849
467,1,5420000,3,20585.21,1,3500606,01/12/2022,20.3,22421,11364,11057,6263,3134,3129
468,1,3915000,3,62055.33,1,2522471,01/12/2022,21.9,9864,5093,4771,3123,1529,1594
469,1,5799000,3,82534.66,1,3752013,01/12/2022,22.3,7888,4037,3851,3058,1509,1549
470,1,9412000,3,21846.33,1,6095521,01/12/2022,19.6,5524,2885,2639,1817,894,923
472,1,5385000,3,21208.28,1,3476415,01/12/2022,20,10328,5288,5040,3690,1794,1896
473,1,2431000,3,25530.35,1,1558695,01/12/2022,22.3,4810,2229,2581,1556,759,797
474,3,176872000,1,95494.57,3,114800069,01/12/2022,18.8,329404,168547,160857,90108,44605,45503
475,3,325601000,1,22211.98,3,211354599,01/12/2022,18.7,855563,431621,423942,240318,117646,122672
476,2,73023000,2,28758.56,2,47386253,01/12/2022,16.7,117253,59414,57839,33098,16300,16798
477,3,113272000,2,71140.65,3,73562372,01/12/2022,14.2,176685,87738,88947,53884,26504,27380
478,3,129340000,1,40961.44,3,83947991,01/12/2022,11.8,261137,131158,129979,84004,41439,42565
479,2,81897000,2,22493.63,2,53180930,01/12/2022,18.1,120926,61958,58968,34805,17098,17707
480,2,51311000,3,194311.37,2,33318053,01/12/2022,14.8,67604,34141,33463,21101,10330,10771
481,1,24829000,3,47040.3,1,16115585,01/12/2022,18.3,38886,19733,19153,11641,5731,5910
482,2,32326000,3,27476.66,2,20986683,01/12/2022,17.4,30324,15540,14784,8298,4088,4210
483,2,48169000,3,47485.68,2,31273383,01/12/2022,8.9,91029,45722,45307,30379,15003,15376
484,2,42442000,3,25462.58,2,27555488,01/12/2022,14.7,62301,30877,31424,20494,10127,10367
485,1,4476000,3,56783.78,1,2887351,01/12/2022,15.1,12987,6460,6527,4296,2156,2140
486,2,30226000,3,102375.76,2,19620571,01/12/2022,10.9,38113,19225,18888,12385,6138,6247
487,1,3929000,3,24155.88,1,2527750,01/12/2022,17.5,12372,6340,6032,3845,1851,1994
488,1,21376000,3,19988.98,1,13864798,01/12/2022,15.5,39474,19169,20305,14904,7336,7568
489,1,25788000,3,30083.69,1,16739092,01/12/2022,8.1,30429,15578,14851,9786,4826,4960
490,1,10897000,3,20643.84,1,7056721,01/12/2022,17.2,13153,6653,6500,4059,2009,2050
491,1,8523000,3,33962.33,1,5516712,01/12/2022,12.1,11440,5836,5604,4121,2095,2026
492,1,4448000,3,52712.28,1,2869210,01/12/2022,12.4,4787,2437,2350,1357,684,673
493,3,182593000,1,20816.28,3,118514977,01/12/2022,25.9,340060,178122,161938,86078,42456,43622
494,2,76667000,3,23746.35,2,49790700,01/12/2022,24.7,43035,22773,20262,11996,6054,5942
495,2,37312000,3,29103.58,2,24217645,01/12/2022,25.4,27182,14325,12857,8434,4220,4214
496,1,28226000,3,26328.56,1,18324155,01/12/2022,24.7,21003,10909,10094,6452,3209,3243
497,2,41245000,3,14257.69,2,26768836,01/12/2022,25.6,31435,16316,15119,9125,4445,4680
498,2,35084000,3,15826.91,2,22763639,01/12/2022,25,29068,15153,13915,8638,4280,4358
499,2,33036000,3,23514.61,2,21450182,01/12/2022,26,25555,13197,12358,7191,3479,3712
500,1,9470000,3,30174.59,1,6133014,01/12/2022,25.2,13944,7272,6672,4420,2177,2243
501,2,36288000,3,21934.59,2,23558096,01/12/2022,25.3,34946,17956,16990,11208,5422,5786
502,1,25883000,3,26624.34,1,16792956,01/12/2022,25.2,16679,8618,8061,4633,2284,2349
503,3,112492000,2,46256.08,3,73037265,01/12/2022,22,297373,155718,141655,71865,35366,36499
504,3,284068000,1,24243.58,3,184443587,01/12/2022,18.6,691557,348387,343170,213267,104895,108372
505,3,130850000,2,32604.59,3,84978199,01/12/2022,15.6,416055,211059,204996,132268,65355,66913
506,2,35282000,3,17104.98,2,22898747,01/12/2022,18.7,111314,55902,55412,35576,17423,18153
507,3,125217000,2,119083.62,3,81294907,01/12/2022,19.9,332100,171749,160351,94911,46503,48408
508,2,58995000,3,49255.43,2,38295184,01/12/2022,21.2,79515,41903,37612,21445,10720,10725
509,2,53669000,2,36255.15,2,34817102,01/12/2022,21.9,205933,107685,98248,49242,24249,24993
510,1,23716000,3,26484.58,1,15392655,01/12/2022,17.9,48172,24667,23505,15031,7399,7632
511,1,17331000,3,23336.17,1,11240032,01/12/2022,18.7,18592,8945,9647,4116,2046,2070
512,2,61531000,3,103753.09,2,39959047,01/12/2022,22,79824,40689,39135,24808,12213,12595
513,1,3936000,3,88979.4,1,2538051,01/12/2022,18.7,10327,5388,4939,2996,1506,1490
514,1,14733000,3,26796.11,1,9556815,01/12/2022,18.7,28215,14347,13868,9384,4582,4802
515,1,12999000,3,26910.04,1,8442751,01/12/2022,21.6,10993,5737,5256,3544,1803,1741
516,1,5782000,3,46428.99,1,3742559,01/12/2022,21.8,11311,5841,5470,3667,1812,1855
517,2,36580000,3,24505.84,2,23738827,01/12/2022,10.1,53373,27810,25563,15744,7755,7989
518,2,54001000,2,538536.4,2,35020592,01/12/2022,14.4,13555,7357,6198,3051,1547,1504
519,2,40757000,3,19083.31,2,26450795,01/12/2022,10.7,59871,31271,28600,19112,9469,9643
520,2,65107000,2,56385.05,2,42243044,01/12/2022,14.1,47632,25410,22222,12563,6265,6298
521,1,27841000,3,23898.56,1,18064390,01/12/2022,13.4,45587,23716,21871,14000,6913,7087
522,1,22356000,3,14050.69,1,14507355,01/12/2022,11,37704,19683,18021,12453,6131,6322
523,1,19644000,3,36605.94,1,12749657,01/12/2022,10.1,70224,35655,34569,24421,12033,12388
524,1,7149000,3,22048.87,1,4605407,01/12/2022,10.1,17978,9382,8596,6248,3105,3143
525,1,2322000,3,125140.61,1,1485074,01/12/2022,10.1,13401,6929,6472,4288,2149,2139
526,1,2200000,3,6637.16,1,1413980,01/12/2022,10.1,30417,15670,14747,9405,4719,4686
527,1,10719000,3,188854.73,1,6937494,01/12/2022,10.1,28657,14853,13804,9078,4552,4526
528,1,1989000,3,54372.47,1,1281399,01/12/2022,10.1,1583,826,757,480,230,250
529,2,89620000,2,219735.07,2,58161164,01/12/2022,19.6,139075,74465,64610,36819,18286,18533
530,2,97991000,2,31121.92,2,63590940,01/12/2022,17.2,120500,65043,55457,29046,14403,14643
531,3,118734000,2,23321.63,3,77121703,01/12/2022,24.5,101336,54039,47297,24763,12096,12667
532,3,246768000,1,223114.41,3,160078588,01/12/2022,23.1,405952,215818,190134,89205,43880,45325
533,3,109901000,1,24648.87,3,71291533,01/12/2022,24,212540,111746,100794,51580,25268,26312
534,3,114671000,1,80058.21,3,74407020,01/12/2022,22.4,180057,96347,83710,45301,22589,22712
535,3,118324000,1,41442.59,3,76689434,01/12/2022,17,443063,237967,205096,110147,54509,55638
536,2,45322000,3,24322.41,2,29433770,01/12/2022,20,33226,17650,15576,10241,5095,5146
537,1,16002000,3,23840.42,1,10376125,01/12/2022,24,15512,8193,7319,4859,2440,2419
538,2,72010000,2,258236.05,2,46745209,01/12/2022,21.1,64445,34215,30230,17692,8626,9066
539,2,61951000,3,22918.15,2,40219658,01/12/2022,23.8,48567,25769,22798,13570,6693,6877
540,2,38286000,3,130446.89,2,24861139,01/12/2022,11.6,42451,22342,20109,14824,7241,7583
541,2,35020000,3,124927.56,2,22734626,01/12/2022,21.6,41588,21739,19849,12522,6161,6361
543,2,39196000,3,33741.5,2,25427747,01/12/2022,22.4,55452,29697,25755,14940,7380,7560
544,1,2629000,3,72262.06,1,1688243,01/12/2022,23.1,6076,3180,2896,1703,844,859
545,2,61577000,2,21665.32,2,39960793,01/12/2022,22.4,64692,34002,30690,19678,9778,9900
546,1,6670000,3,59725.32,1,4308092,01/12/2022,23,22760,12125,10635,6420,3229,3191
547,1,26394000,3,107209.09,1,17120688,01/12/2022,22.7,25608,13480,12128,7723,3870,3853
548,1,19924000,3,84473.96,1,12899875,01/12/2022,21.1,15733,8506,7227,4079,2054,2025
549,1,12952000,3,20950.98,1,8392936,01/12/2022,17.2,41785,22480,19305,10854,5445,5409
550,1,18195000,3,98914.9,1,11793699,01/12/2022,22.3,13225,6946,6279,3476,1669,1807
551,1,26198000,3,26659.72,1,16991338,01/12/2022,15.2,28655,15243,13412,8764,4302,4462
552,1,9471000,3,20462.67,1,6121499,01/12/2022,22.3,17727,9423,8304,4199,2068,2131
553,1,21089000,2,26962.71,1,13618199,01/12/2022,24,8969,4883,4086,2821,1444,1377
554,1,17754000,3,130688.12,1,11516408,01/12/2022,24.3,16758,8967,7791,4993,2542,2451
555,2,56286000,3,25707.29,2,36539471,01/12/2022,23.1,47035,25085,21950,12872,6289,6583
556,2,32418000,3,35829.95,2,21039401,01/12/2022,23.9,55720,29557,26163,14521,7123,7398
557,2,35072000,3,64937.37,2,22768120,01/12/2022,22,46909,24866,22043,15156,7483,7673
558,1,27718000,3,22744.59,1,17987723,01/12/2022,22,33986,17827,16159,9043,4421,4622
559,1,22461000,3,19834.22,1,14565342,01/12/2022,17.2,34847,18666,16181,8943,4380,4563
560,1,19107000,3,14180,1,12382704,01/12/2022,23.1,14304,7545,6759,4455,2182,2273
561,1,17139000,3,153100.06,1,11112522,01/12/2022,22.1,20797,10995,9802,4991,2418,2573
562,1,27825000,3,320612.31,1,18055640,01/12/2022,23,30232,15727,14505,8913,4281,4632
563,2,41193000,2,7487.22,2,26705949,01/12/2022,22.5,20165,10621,9544,5395,2701,2694
564,1,4014000,3,23203.89,1,2589378,01/12/2022,22.4,20380,10692,9688,6259,3127,3132
565,1,16572000,3,9284.19,1,10744110,01/12/2022,11.8,21640,11976,9664,7433,3885,3548
566,2,29886000,3,23696.9,2,19390916,01/12/2022,14.7,33402,17876,15526,9753,4761,4992
567,2,39044000,3,24708.56,2,25333615,01/12/2022,20.7,26236,13620,12616,8067,3962,4105
568,1,5240000,3,31241.47,1,3384721,01/12/2022,23.6,4405,2358,2047,1451,735,716
569,1,5416000,3,25052.87,1,3497541,01/12/2022,22.6,13716,7109,6607,3981,1920,2061
570,1,19710000,3,26328.56,1,12784704,01/12/2022,23.1,5653,2987,2666,1709,826,883
571,1,17376000,3,22992.59,1,11259904,01/12/2022,21.7,21318,11472,9846,5688,2873,2815
572,1,16128000,3,20637.71,1,10459679,01/12/2022,23.1,14582,7621,6961,4539,2262,2277
573,1,2625000,3,36204.6,1,1677475,01/12/2022,23.2,6219,3311,2908,1883,941,942
574,1,14212000,3,15099.91,1,9205427,01/12/2022,24.9,31856,17018,14838,8563,4318,4245
575,1,25300000,3,170472.56,1,16421678,01/12/2022,17.2,35893,18883,17010,11399,5600,5799
576,2,32209000,3,21934.59,2,20905568,01/12/2022,21.7,19272,10328,8944,5163,2534,2629
577,1,23450000,3,25122.17,1,15212988,01/12/2022,11.1,16364,8711,7653,5250,2654,2596
578,1,17819000,3,221165.56,1,11556549,01/12/2022,23.1,2820,1449,1371,720,341,379
579,1,2781000,3,25624.69,1,1787059,01/12/2022,24,4654,2510,2144,1296,630,666
580,1,2369000,3,22005.78,1,1517844,01/12/2022,11.1,21585,11243,10342,6456,3197,3259
581,1,2283000,3,20349.36,1,1461435,01/12/2022,23.1,6888,3543,3345,1840,922,918
582,1,2337000,3,23088.56,1,1494304,01/12/2022,22.5,21391,11404,9987,5619,2742,2877
583,1,2532000,3,24837.87,1,1623622,01/12/2022,23,9668,5030,4638,2384,1141,1243
584,2,29195000,3,57188.3,2,18952016,01/12/2022,24.9,13995,7311,6684,4212,2070,2142
585,1,6073000,3,4691.68,1,3924799,01/12/2022,23.9,6838,3583,3255,1791,891,900
586,1,1982000,3,21826.88,1,1266122,01/12/2022,22.5,5681,3058,2623,1606,823,783
587,1,13674000,3,22278.56,1,8861642,01/12/2022,11.1,13966,7679,6287,3739,1859,1880
588,1,24374000,3,22178.18,1,15823456,01/12/2022,24,28076,14773,13303,7550,3752,3798
589,1,11708000,3,49326.88,1,7582243,01/12/2022,8.9,34039,18008,16031,8858,4334,4524
590,1,2658000,3,5449.44,1,1708789,01/12/2022,17.2,15807,8231,7576,5949,2955,2994
591,1,1801000,3,51706.84,1,1156392,01/12/2022,23.9,10581,5508,5073,2907,1418,1489
592,1,4395000,3,33996.67,1,2831697,01/12/2022,15.4,9554,4935,4619,2707,1302,1405
593,1,27928000,2,106575.3,1,18086932,01/12/2022,22,9988,5342,4646,2237,1127,1110
594,1,3144000,3,32259.99,1,2029420,01/12/2022,23.4,7578,3984,3594,2088,1031,1057
595,1,3951000,3,24797.59,1,2545291,01/12/2022,17,8005,4106,3899,2599,1296,1303
596,1,3498000,3,46542.77,1,2251725,01/12/2022,24,24085,12288,11797,7909,3780,4129
597,1,5685000,3,21660.94,1,3672764,01/12/2022,22.5,7455,4054,3401,2223,1145,1078
598,1,1638000,3,22235.18,1,1056024,01/12/2022,24.9,17919,9538,8381,4548,2298,2250
599,1,8777000,3,94249.23,1,5680544,01/12/2022,22.4,15305,8066,7239,4706,2332,2374
600,3,290041000,1,252769.59,3,188273926,01/12/2022,25.7,921771,479309,442462,222551,109790,112761
601,2,29102000,3,5251.77,2,18894471,01/12/2022,23.5,26081,13338,12743,7626,3791,3835
602,2,47949000,3,22858.87,2,31141143,01/12/2022,26.5,56494,29131,27363,17460,8617,8843
603,2,34281000,3,22178.18,2,22258751,01/12/2022,25.1,52593,26982,25611,16883,8307,8576
604,1,9303000,3,43975.52,1,6017074,01/12/2022,25.6,41965,21110,20855,11192,5453,5739
605,1,18812000,3,23476.83,1,12199631,01/12/2022,24.3,26175,13553,12622,8885,4301,4584
606,1,24863000,3,21704.9,1,16134040,01/12/2022,23.5,35183,17868,17315,10650,5230,5420
607,1,21782000,3,27353.63,1,14131640,01/12/2022,23.2,56409,28489,27920,16919,8292,8627
608,1,18266000,3,23088.56,1,11858493,01/12/2022,23.2,139753,70456,69297,45077,22298,22779
609,1,15713000,3,62332.11,1,10189947,01/12/2022,24.4,17841,9042,8799,5372,2677,2695
610,1,14756000,3,22485.56,1,9570756,01/12/2022,23.2,28461,14574,13887,9148,4533,4615
611,2,60604000,2,53838.25,2,39328739,01/12/2022,13.9,143281,73905,69376,47529,23519,24010
612,2,73620000,1,22991.89,2,47746425,01/12/2022,13,138444,72335,66109,38201,18773,19428
613,1,21147000,3,24471,1,13721079,01/12/2022,13.9,22295,11690,10605,8176,4115,4061
614,1,22097000,3,47011,1,14316039,01/12/2022,13.5,25068,12776,12292,8673,4237,4436
615,1,4864000,3,22425,1,3139175,01/12/2022,14.4,15291,7886,7405,5051,2477,2574
616,1,7220000,3,22623,1,4670377,01/12/2022,12.9,38193,19467,18726,13775,6896,6879
617,1,16930000,3,24028,1,10980472,01/12/2022,14.9,46132,23831,22301,13972,6871,7101
618,1,2695000,3,21935,1,1729815,01/12/2022,19.1,13641,7027,6614,4307,2133,2174
1,3,113555000,1,183190,3,73627560,01/11/2022,18.5,863893,444725,419168,260350,128225,132125
2,1,19263000,3,27018,1,12493932,01/11/2022,18,31963,16433,15530,11390,5609,5781
3,1,11917000,3,26117,1,7719933,01/11/2022,16.7,63805,32406,31399,23397,11652,11745
4,1,12501000,3,27145,1,8098505,01/11/2022,18,21049,10874,10175,7097,3529,3568
5,1,5366000,3,23435,1,3464465,01/11/2022,16.1,32035,16367,15668,10989,5374,5615
6,3,236611000,1,251876,3,153545274,01/11/2022,17.9,854186,425977,428209,227917,112151,115766
7,3,434023000,1,540020,3,281574930,01/11/2022,15.2,1810645,899293,911352,503963,246971,256992
8,2,93884000,2,96674,2,60927926,01/11/2022,14.6,330652,167339,163313,86895,42903,43992
9,2,39285000,3,27477,2,25507773,01/11/2022,13.5,81059,40420,40639,23492,11470,12022
10,2,37845000,2,55017,2,24544233,01/11/2022,15.9,100660,49935,50725,28067,13772,14295
11,1,21970000,3,26624,1,14253876,01/11/2022,16.4,19081,9476,9605,5934,2909,3025
12,3,101796000,1,126024,3,66041376,01/11/2022,22.7,250141,126245,123896,65670,32312,33358
13,2,64264000,2,84807,2,41686793,01/11/2022,22.2,136285,66083,70202,42780,21001,21779
14,2,87341000,1,132568,2,56639082,01/11/2022,24.6,202694,98608,104086,64935,31858,33077
15,2,29460000,3,35869,2,19113131,01/11/2022,19.7,43805,22160,21645,13050,6507,6543
16,2,33111000,2,69211,2,21452939,01/11/2022,21.7,16311,8010,8301,4984,2435,2549
17,1,13229000,3,27139,1,8571711,01/11/2022,19.7,14357,6822,7535,3854,1925,1929
18,1,3498000,3,22701,1,2250999,01/11/2022,15.3,13596,6842,6754,4196,2086,2110
19,1,10942000,3,25122,1,7087178,01/11/2022,17,13596,6842,6754,4196,2086,2110
20,1,4300000,3,23839,1,2771161,01/11/2022,23.3,7185,3509,3676,2099,1015,1084
21,2,48654000,2,68961,2,31556139,01/11/2022,27.1,191238,97313,93925,52600,25862,26738
22,2,50486000,2,81999,2,32733901,01/11/2022,27.7,249623,130524,119099,66498,32635,33863
23,2,35663000,3,26853,2,23154097,01/11/2022,28.2,31375,16375,15000,10682,5317,5365
24,1,22123000,3,27295,1,14352655,01/11/2022,26.7,35799,18291,17508,11962,5883,6079
25,1,13738000,3,27748,1,8901952,01/11/2022,27.5,15949,8217,7732,4538,2234,2304
26,3,103911000,2,95495,3,67446655,01/11/2022,27.4,217550,113613,103937,65123,32048,33075
27,2,58756000,3,46552,2,38144848,01/11/2022,16.6,183509,96930,86579,60413,30246,30167
28,2,63366000,2,65139,2,41122761,01/11/2022,19,113479,60064,53415,36594,18199,18395
29,3,123460000,1,110120,3,80138880,01/11/2022,25.1,578830,303756,275074,166456,82025,84431
30,2,45134000,3,46574,2,29290526,01/11/2022,26.6,51797,27093,24704,17614,8812,8802
31,2,67081000,1,132442,2,43470208,01/11/2022,24.9,38087,20017,18070,11916,5833,6083
32,1,16252000,3,23726,1,10540074,01/11/2022,28.2,32109,16780,15329,10495,5074,5421
33,2,31961000,3,40356,2,20734294,01/11/2022,23.3,21727,11415,10312,7786,3890,3896
34,1,18426000,3,28208,1,11948692,01/11/2022,25.3,49201,25651,23550,16539,8102,8437
35,1,26946000,3,36205,1,17478695,01/11/2022,24.4,37546,19668,17878,11791,5836,5955
36,2,31528000,2,76573,2,20416627,01/11/2022,18.6,47688,25247,22441,17870,8920,8950
37,1,5499000,3,23479,1,3550871,01/11/2022,26.1,55931,28786,27145,18430,9082,9348
38,1,14234000,3,26882,1,9225218,01/11/2022,22.9,29018,15064,13954,10291,5191,5100
39,1,12405000,3,36450,1,8026800,01/11/2022,24.5,18219,9592,8627,5806,2838,2968
40,1,17704000,3,25726,1,11481874,01/11/2022,26.7,15244,8058,7186,4848,2429,2419
41,1,6582000,3,22538,1,4255762,01/11/2022,29.1,25366,13345,12021,7752,3823,3929
42,1,21113000,3,23632,1,13699818,01/11/2022,26.9,19271,9996,9275,6517,3095,3422
43,1,4446000,3,20951,1,2868949,01/11/2022,28.1,7662,4073,3589,2321,1153,1168
44,1,8020000,3,23515,1,5189485,01/11/2022,19.2,20044,10360,9684,7602,3787,3815
45,3,373741000,1,260308,3,242671342,01/11/2022,9.7,1501551,750157,751394,459910,225614,234296
46,3,137410000,1,194542,3,89121958,01/11/2022,13.1,925762,474776,450986,250961,123448,127513
47,2,35127000,2,54414,2,22778136,01/11/2022,15.5,128548,65838,62710,37721,18411,19310
48,2,30450000,3,46357,2,19746143,01/11/2022,12.5,135586,69677,65909,41627,20458,21169
49,2,35869000,2,66391,2,23248459,01/11/2022,14.8,113843,59214,54629,34117,16974,17143
50,1,6077000,3,22608,1,3927442,01/11/2022,19,23140,11693,11447,7155,3499,3656
51,1,10626000,3,24741,1,6882159,01/11/2022,14.8,35087,17902,17185,11563,5663,5900
52,1,15672000,3,34768,1,10152032,01/11/2022,14.4,42019,21548,20471,12599,6234,6365
53,1,11924000,3,31132,1,7719468,01/11/2022,14.2,22066,11231,10835,6719,3420,3299
54,1,10546000,3,25528,1,6829372,01/11/2022,8,17410,9121,8289,6393,3204,3189
55,1,2226000,3,22745,1,1424155,01/11/2022,15,22568,11549,11019,7200,3540,3660
56,1,7456000,3,23609,1,4822791,01/11/2022,8.6,15054,7516,7538,5557,2768,2789
57,1,4969000,2,70707,1,3159143,01/11/2022,11.6,8253,4210,4043,2801,1419,1382
58,1,5606000,3,22486,1,3621414,01/11/2022,7.9,7834,4065,3769,2439,1200,1239
59,1,2073000,3,21481,1,1325969,01/11/2022,5.4,14755,7617,7138,4907,2427,2480
60,1,16813000,3,29022,1,10899428,01/11/2022,11.2,62038,31762,30276,19262,9511,9751
61,3,119691000,1,124912,3,77674238,01/11/2022,19.4,690193,353744,336449,203574,99881,103693
62,3,169895000,1,187274,3,110244476,01/11/2022,14.9,864431,434753,429678,267728,131619,136109
63,2,53748000,2,81369,2,34854831,01/11/2022,18.7,237169,119538,117631,71348,35023,36325
64,2,59873000,2,70173,2,38847277,01/11/2022,21.7,173959,86825,87134,55826,27459,28367
65,1,12933000,3,24838,1,8381612,01/11/2022,17.1,39058,19755,19303,11201,5479,5722
66,3,130423000,1,166460,3,84608490,01/11/2022,17.9,59762,30506,29256,20025,9931,10094
67,1,20177000,3,25324,1,13089726,01/11/2022,17,49490,25496,23994,16916,8460,8456
68,2,33791000,2,55121,2,21909029,01/11/2022,15.8,160225,79799,80426,53549,26489,27060
69,1,17486000,3,22306,1,11343594,01/11/2022,16.1,114010,56192,57818,38156,18905,19251
70,2,32636000,3,37826,2,21175574,01/11/2022,18.3,75242,37695,37547,23792,11778,12014
71,1,14112000,3,25009,1,9147791,01/11/2022,16.8,59196,29915,29281,18125,8949,9176
72,1,19299000,3,23925,1,12520425,01/11/2022,18.3,32704,16713,15991,11320,5572,5748
73,1,8582000,3,25985,1,5552315,01/11/2022,17.1,23413,11884,11529,7157,3552,3605
74,1,12445000,3,26458,1,8062792,01/11/2022,17.2,38992,19602,19390,13022,6299,6723
75,1,2108000,3,23168,1,1347032,01/11/2022,18.6,27314,13703,13611,9005,4397,4608
76,2,64653000,2,70898,2,41953552,01/11/2022,24.2,146965,75962,71003,46271,22786,23485
77,2,38650000,3,47486,2,25075014,01/11/2022,29.7,88337,44762,43575,34686,17254,17432
78,2,48924000,2,72136,2,31728464,01/11/2022,28.2,159853,80569,79284,57402,28064,29338
79,1,3555000,3,22668,1,2288082,01/11/2022,25.4,9746,4912,4834,3336,1602,1734
80,1,3016000,3,21404,1,1938996,01/11/2022,27.5,15368,7632,7736,5699,2779,2920
81,1,1371000,3,9284,1,881866,01/11/2022,26.5,147496,76348,71148,49524,24280,25244
82,1,1172000,3,22903,1,738897,01/11/2022,27.2,14892,7420,7472,5365,2615,2750
83,1,10524000,3,24123,1,6816477,01/11/2022,16.9,34798,17459,17339,10865,5211,5654
84,2,49645000,1,179844,2,32089406,01/11/2022,18.3,432205,227255,204950,86717,42372,44345
85,2,50474000,1,177102,2,32630998,01/11/2022,18.3,759003,398068,360935,168014,83097,84917
86,3,113356000,1,324864,3,73356536,01/11/2022,18.6,1173351,609477,563874,261635,129105,132530
87,2,33825000,2,62334,2,21923916,01/11/2022,18.5,414470,219003,195467,75588,37198,38390
88,1,22954000,2,55824,1,14864276,01/11/2022,15.2,186693,97615,89078,46165,22603,23562
89,3,192591000,1,395423,3,124788727,01/11/2022,18,1835486,947835,887651,451632,222341,229291
90,2,63195000,1,120625,2,40956125,01/11/2022,18.5,614447,325337,289110,113945,55951,57994
91,2,30470000,2,87096,2,19718404,01/11/2022,18,434153,232032,202121,62030,30612,31418
92,2,65535000,1,125134,2,42472616,01/11/2022,17,323771,167274,156497,83659,40990,42669
93,2,53303000,2,103398,2,34543552,01/11/2022,16.1,404695,212343,192352,85496,42058,43438
94,2,32032000,1,153095,2,20667705,01/11/2022,18,443704,233586,210118,95713,47173,48540
95,2,80385000,1,269484,2,51980766,01/11/2022,16.9,545884,284933,260951,101794,50260,51534
96,1,17242000,2,57186,1,11150114,01/11/2022,16.4,429481,220393,209088,105785,52018,53767
97,1,9885000,3,50178,1,6375072,01/11/2022,12.6,246428,128767,117661,58169,28791,29378
98,1,14531000,3,31120,1,9414030,01/11/2022,12.6,599935,314284,285651,130174,64060,66114
99,3,144807000,1,155863,3,93968687,01/11/2022,16.1,616068,317266,298802,191866,94056,97810
100,2,81853000,2,93543,2,53110907,01/11/2022,15.2,301742,154079,147663,97495,48007,49488
101,1,11980000,3,19974,1,7767026,01/11/2022,16.8,96243,49040,47203,29383,14345,15038
102,1,19285000,3,35042,1,12500208,01/11/2022,17.8,30063,15334,14729,10450,5151,5299
103,1,1785000,2,92852,1,1067398,01/11/2022,23.7,3222,1654,1568,1247,637,610
104,1,15513000,2,56188,1,10027262,01/11/2022,15.1,17967,9205,8762,6003,2945,3058
105,1,2802000,3,21273,1,1800027,01/11/2022,14.7,11943,6311,5632,3854,1993,1861
106,1,2177000,2,91490,1,1323560,01/11/2022,17.7,12850,6538,6312,4678,2267,2411
107,2,46377000,1,105002,2,30040048,01/11/2022,8.7,26678,13733,12945,10032,4897,5135
108,3,198143000,1,246124,3,128546826,01/11/2022,13.7,223876,119352,104524,50306,24928,25378
109,2,70461000,1,195769,2,45603881,01/11/2022,15.2,515353,266081,249272,126007,61695,64312
110,3,121092000,1,321367,3,78388433,01/11/2022,16.6,776220,402522,373698,193769,95439,98330
111,2,67094000,2,94117,2,43516983,01/11/2022,15.9,84298,43745,40553,23019,11356,11663
112,2,54315000,2,59725,2,35245025,01/11/2022,18.4,30929,15848,15081,8319,4034,4285
113,2,37476000,1,117585,2,24241815,01/11/2022,15.3,293245,152241,141004,70657,34731,35926
114,2,69915000,1,219713,2,45225037,01/11/2022,14.9,658907,338453,320454,150053,73914,76139
115,2,30628000,3,31051,2,19877149,01/11/2022,14.9,117995,60165,57830,29983,14851,15132
116,3,197464000,1,339869,3,128011731,01/11/2022,13.9,1643623,845932,797691,437489,216020,221469
117,2,85108000,1,159735,2,55160465,01/11/2022,17.6,368585,190133,178452,107535,52900,54635
118,2,56002000,2,64936,2,36336364,01/11/2022,9.5,174704,91497,83207,54449,28355,26094
119,1,23512000,3,49245,1,15233555,01/11/2022,6.9,2931,1520,1411,975,512,463
120,2,63971000,2,103756,2,41477394,01/11/2022,9.3,35491,18986,16505,7987,3993,3994
121,2,71600000,1,161123,2,46378877,01/11/2022,15.9,703215,359601,343614,230612,113552,117060
122,2,71457000,1,199138,2,46247912,01/11/2022,16.5,18226,9300,8926,5308,2603,2705
123,2,60555000,2,76511,2,39284239,01/11/2022,16,1072676,556998,515678,265425,131078,134347
124,1,26355000,3,11547,1,17119203,01/11/2022,20.2,14038,7254,6784,3763,1910,1853
125,2,80839000,2,98833,2,52446517,01/11/2022,9.5,174704,91497,83207,54449,28355,26094
126,2,61192000,3,33722,2,39741078,01/11/2022,23.7,7077,3593,3484,1748,893,855
127,2,43598000,2,53838,2,28284862,01/11/2022,16,53362,27304,26058,15169,7515,7654
128,1,19598000,3,23746,1,12714954,01/11/2022,5.1,24612,12254,12358,7339,3541,3798
129,2,55393000,1,173456,2,35831994,01/11/2022,16.1,10873,5623,5250,3757,1878,1879
130,2,67817000,2,56093,2,44024957,01/11/2022,14.7,23219,12339,10880,6425,3186,3239
131,2,30088000,3,33864,2,19523336,01/11/2022,15.8,12671,6512,6159,3454,1710,1744
132,1,26183000,3,30082,1,16988868,01/11/2022,13.9,30967,16277,14690,10756,5327,5429
133,2,47786000,2,56371,2,31004529,01/11/2022,17.2,323545,166328,157217,93932,46757,47175
134,1,7847000,3,19141,1,5081409,01/11/2022,20,19326,10155,9171,6252,3129,3123
135,1,23854000,3,30515,1,15474585,01/11/2022,9.5,33716,17686,16030,9317,4624,4693
136,1,13716000,3,49252,1,8866148,01/11/2022,14.4,40279,20716,19563,10282,5078,5204
137,1,3893000,3,23013,1,2507437,01/11/2022,15.6,29068,14916,14152,8580,4220,4360
138,2,32107000,2,56855,2,20812695,01/11/2022,16.6,12752,6694,6058,3471,1768,1703
139,1,5719000,3,48338,1,3669012,01/11/2022,13.3,33166,16973,16193,9497,4707,4790
140,1,7792000,3,15827,1,5048973,01/11/2022,14.9,52828,27143,25685,16500,8128,8372
141,2,37168000,3,27354,2,24131846,01/11/2022,15.1,32738,16941,15797,9059,4431,4628
142,1,11514000,3,25864,1,7458236,01/11/2022,15.6,30203,15792,14411,7568,3777,3791
143,2,35308000,3,39601,2,22910599,01/11/2022,14.9,11760,6069,5691,3432,1700,1732
144,1,12185000,3,21665,1,7898585,01/11/2022,16,72525,37076,35449,22128,10944,11184
145,1,10433000,3,25580,1,6755870,01/11/2022,6.9,18580,9729,8851,5724,2801,2923
146,1,22454000,3,30175,1,14564925,01/11/2022,16.5,24575,12798,11777,7126,3453,3673
147,1,1316000,3,19601,1,835799,01/11/2022,15.3,44731,22925,21806,13335,6514,6821
148,1,9356000,2,54372,1,6027028,01/11/2022,15.2,658907,338453,320454,150053,73914,76139
149,1,17623000,3,25053,1,11429897,01/11/2022,17.1,10336,5387,4949,3449,1664,1785
150,1,13681000,3,37667,1,8854983,01/11/2022,13.8,4656,2421,2235,1533,751,782
151,1,9104000,3,31241,1,5886359,01/11/2022,17.2,9598,5002,4596,2910,1467,1443
152,1,11829000,3,22102,1,7666748,01/11/2022,14.9,15171,7853,7318,4470,2251,2219
153,1,6508000,3,23596,1,4206604,01/11/2022,15.6,10792,5577,5215,3492,1713,1779
154,1,2311000,3,4006,1,1498144,01/11/2022,14.9,37442,19141,18301,12089,5963,6126
155,1,4748000,3,22471,1,3063729,01/11/2022,9.5,17736,9182,8554,5577,2775,2802
156,1,9560000,3,13220,1,6200780,01/11/2022,16.5,386290,199249,187041,112223,55337,56886
157,1,11130000,3,29986,1,7204514,01/11/2022,16.5,9925,5218,4707,2833,1403,1430
158,1,10784000,3,24368,1,6985232,01/11/2022,20.2,6944,3666,3278,2341,1149,1192
159,1,8554000,3,28619,1,5531481,01/11/2022,13.9,88734,45471,43263,28316,14166,14150
160,1,10419000,3,21473,1,6750877,01/11/2022,9.3,6449,3346,3103,1687,833,854
161,1,7141000,3,22152,1,4619498,01/11/2022,13,10735,5576,5159,3010,1518,1492
162,1,3206000,3,21551,1,2062349,01/11/2022,9.3,10810,5614,5196,2941,1451,1490
163,1,1511000,3,956,1,981194,01/11/2022,23.7,13038,6614,6424,4157,2015,2142
165,3,209178000,1,234238,3,135731462,01/11/2022,20.5,1579803,804212,775591,594938,292494,302444
166,2,84992000,2,83887,2,55160913,01/11/2022,17,378143,194849,183294,128863,62806,66057
167,2,84240000,2,56770,2,54699230,01/11/2022,17.1,452090,230346,221744,162764,80177,82587
168,1,23763000,3,33752,1,15412198,01/11/2022,20.2,69371,35473,33898,25304,12303,13001
169,2,34567000,2,68090,2,22400460,01/11/2022,18.5,79772,40908,38864,30907,15312,15595
170,2,30011000,3,37951,2,19469199,01/11/2022,19.3,56597,29703,26894,19146,9514,9632
171,1,27233000,3,35825,1,17665625,01/11/2022,17.9,72663,38036,34627,27395,13712,13683
172,2,52308000,2,81080,2,33919120,01/11/2022,18.9,160682,83178,77504,52342,25860,26482
173,2,35289000,3,34659,2,22903191,01/11/2022,18.1,83352,42766,40586,32937,16375,16562
174,2,35191000,3,37355,2,22836795,01/11/2022,16.5,67101,35567,31534,27008,13393,13615
175,1,20479000,3,38257,1,13273093,01/11/2022,19.4,43249,22352,20897,17065,8284,8781
176,2,30454000,3,37482,2,19757618,01/11/2022,16.5,51894,27702,24192,20579,10113,10466
177,1,26820000,3,51935,1,17381065,01/11/2022,18.4,70068,36526,33542,21044,10402,10642
178,1,26400000,3,26963,1,17133037,01/11/2022,18.7,52156,27081,25075,17108,8394,8714
179,1,4559000,3,31699,1,2931651,01/11/2022,18.8,41910,21741,20169,12631,6146,6485
180,1,28163000,3,47258,1,18258692,01/11/2022,17.8,43998,23109,20889,17575,8775,8800
181,1,5827000,3,22486,1,3765064,01/11/2022,21,24757,12827,11930,9816,4898,4918
182,1,4387000,3,22279,1,2829271,01/11/2022,19,21756,11234,10522,8659,4317,4342
183,1,9469000,3,15100,1,6139750,01/11/2022,17.8,28109,14419,13690,10548,5187,5361
184,1,7995000,3,25519,1,5171231,01/11/2022,19.4,15305,7996,7309,5899,2872,3027
185,2,30817000,3,51297,2,19979753,01/11/2022,16.9,72452,38019,34433,23628,11618,12010
186,1,23204000,3,24746,1,15057854,01/11/2022,19.2,35401,18444,16957,12235,5945,6290
187,2,30111000,3,40355,2,19531795,01/11/2022,17.3,27593,14289,13304,10803,5260,5543
188,1,21426000,3,24588,1,13902312,01/11/2022,19.2,31264,16171,15093,9806,4840,4966
189,1,19187000,3,40500,1,12431050,01/11/2022,14.9,24228,12861,11367,9383,4674,4709
190,1,24010000,3,23551,1,15582949,01/11/2022,14.4,32831,17049,15782,13856,6706,7150
191,1,3101000,3,22645,1,1993005,01/11/2022,19.9,16092,8507,7585,6837,3451,3386
192,1,9975000,3,28208,1,6455542,01/11/2022,17.6,8011,4268,3743,3134,1562,1572
193,1,17888000,3,26129,1,11601071,01/11/2022,20.8,29002,14796,14206,11206,5550,5656
194,1,3098000,3,22938,1,1990762,01/11/2022,16.3,7946,4172,3774,3293,1607,1686
195,1,13527000,3,12191,1,8780359,01/11/2022,20.5,28260,14728,13532,11002,5473,5529
196,1,8453000,3,5449,1,5489001,01/11/2022,17.8,25845,13471,12374,9370,4627,4743
197,3,158834000,1,203918,3,103038182,01/11/2022,28.4,658609,345979,312630,183298,90145,93153
198,2,62500000,2,57283,2,40567717,01/11/2022,23.5,225728,119129,106599,71494,35347,36147
199,2,37802000,3,43976,2,24527324,01/11/2022,31.5,70760,36613,34147,21788,10705,11083
200,2,49284000,2,80633,2,31953967,01/11/2022,25.1,132854,69610,63244,41183,20301,20882
201,1,23357000,2,71137,1,15110913,01/11/2022,20.8,50399,26542,23857,14000,6918,7082
202,1,3533000,3,22990,1,2273460,01/11/2022,22.1,27944,14419,13525,9490,4664,4826
203,1,6146000,3,25881,1,3969019,01/11/2022,19.2,22534,11802,10732,7926,3939,3987
204,1,15317000,3,35537,1,9920513,01/11/2022,27.8,25148,13436,11712,8928,4476,4452
205,2,32291000,3,47085,2,20942065,01/11/2022,20.7,33783,18241,15542,12201,6089,6112
206,2,41788000,3,31769,2,27130431,01/11/2022,28.1,25850,13268,12582,8390,4048,4342
208,2,41880000,3,44592,2,27177408,01/11/2022,19.3,27607,14605,13002,9883,5002,4881
209,1,10919000,3,25519,1,7071831,01/11/2022,26.7,13866,7187,6679,4383,2099,2284
210,1,8812000,3,26437,1,5701363,01/11/2022,26.4,23363,12127,11236,7776,3818,3958
211,1,20290000,3,26329,1,13162171,01/11/2022,25.4,18224,9500,8724,7072,3514,3558
212,1,16463000,3,25461,1,10675489,01/11/2022,28.2,16447,8464,7983,4843,2381,2462
213,1,6548000,3,14171,1,4242029,01/11/2022,23.6,17550,9283,8267,5700,2861,2839
214,2,79766000,1,159554,2,51688346,01/11/2022,16.3,297848,156299,141549,74787,37046,37741
215,2,32141000,3,33742,2,20857908,01/11/2022,17.9,29390,15521,13869,7939,3942,3997
216,2,39315000,2,69900,2,25484850,01/11/2022,17.9,37608,20094,17514,11115,5490,5625
217,2,42838000,2,72259,2,27772441,01/11/2022,17.6,106163,56161,50002,30752,15034,15718
218,1,16094000,3,43267,1,10417833,01/11/2022,15,11149,5894,5255,2996,1479,1517
219,2,42386000,2,56384,2,27494516,01/11/2022,14.1,60265,30945,29320,18808,9224,9584
220,1,23214000,3,32552,1,15056548,01/11/2022,18.5,17718,9411,8307,4913,2492,2421
221,1,19976000,3,32605,1,12951795,01/11/2022,17.3,36618,19077,17541,10530,5273,5257
222,1,13985000,3,25551,1,9064699,01/11/2022,17.2,9853,5224,4629,2757,1390,1367
223,1,2775000,3,25669,1,1778081,01/11/2022,17.8,27713,14561,13152,7736,3885,3851
224,1,7458000,3,22279,1,4825421,01/11/2022,16.8,32276,17014,15262,9457,4578,4879
225,1,10675000,3,24322,1,6914428,01/11/2022,17.2,14689,7582,7107,4123,2033,2090
226,2,51132000,3,46489,2,33189311,01/11/2022,22.8,44311,23331,20980,13756,6771,6985
227,1,5275000,3,23477,1,3405273,01/11/2022,19.6,14732,7791,6941,4911,2433,2478
228,1,13752000,3,25175,1,8913625,01/11/2022,16.4,20530,10890,9640,6356,3180,3176
229,1,16193000,3,24244,1,10501206,01/11/2022,22.6,16368,8558,7810,4728,2323,2405
230,1,10125000,3,24709,1,6556541,01/11/2022,14.2,6213,3216,2997,1786,871,915
231,1,14276000,3,25571,1,9253829,01/11/2022,14.1,28792,15288,13504,8327,4111,4216
232,1,7351000,3,22235,1,4755915,01/11/2022,17,29472,15519,13953,9890,4934,4956
233,1,6122000,3,6637,1,3972663,01/11/2022,16.9,8657,4501,4156,2464,1200,1264
234,2,82953000,1,116797,2,53802653,01/11/2022,23.2,224166,112147,112019,65088,31954,33134
235,2,33349000,2,69469,2,21607381,01/11/2022,18.1,111569,57370,54199,36412,17892,18520
236,2,32775000,3,33636,2,21270114,01/11/2022,19,38780,20122,18658,13025,6461,6564
237,3,183479000,1,355366,3,118905984,01/11/2022,19.6,1385621,718628,666993,333198,164217,168981
238,3,123102000,1,255244,3,79761056,01/11/2022,18,1257547,645398,612149,321993,158559,163434
239,1,25110000,3,30626,1,16290874,01/11/2022,19.5,37871,19554,18317,11359,5732,5627
240,3,102928000,1,221987,3,66681213,01/11/2022,21.8,650123,329365,320758,200033,98558,101475
241,2,48286000,2,76310,2,31309590,01/11/2022,20.7,111975,57735,54240,31481,15460,16021
242,1,17383000,3,26624,1,11272326,01/11/2022,19,98842,50427,48415,30938,15263,15675
243,2,78346000,1,195801,2,50729099,01/11/2022,18.2,44103,22420,21683,15768,7755,8013
244,1,12645000,3,26750,1,8192500,01/11/2022,15.8,53539,27205,26334,18000,8916,9084
245,1,14026000,3,26846,1,9090054,01/11/2022,27.8,18787,9476,9311,6502,3270,3232
246,1,20006000,3,36395,1,12967505,01/11/2022,19,59648,30609,29039,19344,9536,9808
247,2,68573000,1,107208,2,44465242,01/11/2022,20.7,30471,15635,14836,9610,4654,4956
248,1,4917000,3,23677,1,3172373,01/11/2022,19.2,20286,10307,9979,6804,3413,3391
249,1,5271000,3,21661,1,3404489,01/11/2022,22.1,20345,10131,10214,6733,3300,3433
250,1,24956000,3,36249,1,16185151,01/11/2022,18.9,31115,15891,15224,10525,5240,5285
251,1,16232000,3,41273,1,10509527,01/11/2022,19.2,16550,8456,8094,5252,2552,2700
252,1,19384000,3,26961,1,12572639,01/11/2022,21.5,24352,12627,11725,8092,4062,4030
253,1,23979000,3,45745,1,15540605,01/11/2022,17.3,94978,48709,46269,29794,14672,15122
254,2,30692000,3,29813,2,19919987,01/11/2022,23.2,52019,26739,25280,15725,7759,7966
255,1,4565000,3,26329,1,2940921,01/11/2022,19.4,24580,12765,11815,8215,4057,4158
256,1,15042000,3,28792,1,9748508,01/11/2022,20.7,28678,14679,13999,9074,4497,4577
257,1,4502000,3,22279,1,2904021,01/11/2022,15.1,22738,11719,11019,7000,3537,3463
258,1,12622000,3,25027,1,8179273,01/11/2022,20.7,28145,14670,13475,8863,4390,4473
259,1,10879000,3,22666,1,7048684,01/11/2022,20.7,19113,9852,9261,5504,2716,2788
260,1,2574000,3,22049,1,1651051,01/11/2022,15.8,25925,13382,12543,8585,4189,4396
261,1,1051000,3,22193,1,660957,01/11/2022,20.7,13033,6697,6336,4420,2181,2239
262,1,3648000,3,22212,1,2348988,01/11/2022,9.6,5955,3118,2837,1972,974,998
263,1,1801000,3,17612,1,1153038,01/11/2022,18.9,8850,4524,4326,2773,1377,1396
264,1,2897000,3,20463,1,1862587,01/11/2022,15.1,9529,4943,4586,3018,1490,1528
265,1,11195000,3,29355,1,7247395,01/11/2022,15.8,14636,7533,7103,4910,2424,2486
266,1,20942000,3,33359,1,13578941,01/11/2022,19.2,40906,20800,20106,12864,6409,6455
267,1,7910000,3,24526,1,5116974,01/11/2022,20.7,8142,4289,3853,2686,1333,1353
268,1,2590000,3,22257,1,1661243,01/11/2022,15.1,7954,4060,3894,2570,1274,1296
269,1,12541000,3,24762,1,8126888,01/11/2022,18.9,17000,8527,8473,5215,2549,2666
270,1,3936000,3,22301,1,2536099,01/11/2022,16.9,14424,7439,6985,5399,2678,2721
271,1,2627000,3,22173,1,1685377,01/11/2022,18.9,16873,8725,8148,6022,3008,3014
272,1,3289000,3,17711,1,2120139,01/11/2022,20.7,5109,2618,2491,1631,805,826
273,1,2825000,3,22494,1,1813756,01/11/2022,20.7,13243,6795,6448,4043,1954,2089
274,1,3836000,3,22279,1,2471121,01/11/2022,15.8,14497,7627,6870,4260,2099,2161
275,1,2869000,3,19082,1,1845768,01/11/2022,20,16324,8373,7951,5562,2774,2788
276,1,6291000,3,22918,1,4066232,01/11/2022,26.5,9842,5047,4795,3323,1629,1694
277,1,3047000,3,21502,1,1959048,01/11/2022,15.8,27833,14525,13308,9097,4581,4516
278,1,6277000,3,5252,1,4074798,01/11/2022,19.8,33284,17172,16112,10804,5349,5455
279,1,2388000,3,22500,1,1529700,01/11/2022,23.3,14697,7601,7096,4740,2380,2360
280,1,5042000,3,19152,1,3258148,01/11/2022,17.3,18607,9363,9244,6403,3178,3225
283,1,2320000,3,21116,1,1486884,01/11/2022,22.1,11110,5642,5468,3479,1704,1775
284,3,125435000,1,162207,3,81370543,01/11/2022,16.5,743275,388114,355161,202467,99875,102592
285,2,50112000,2,94249,2,32478551,01/11/2022,17.6,154546,80401,74145,48513,24003,24510
286,2,81516000,1,129337,2,52856063,01/11/2022,18.7,299523,155411,144112,93845,46362,47483
287,2,50341000,2,87928,2,32633722,01/11/2022,28.1,83637,42325,41312,24783,12286,12497
288,2,43001000,2,85363,2,27865287,01/11/2022,28.5,102362,52461,49901,35162,17416,17746
289,1,20761000,3,33995,1,13460655,01/11/2022,19.6,55287,28877,26410,16959,8447,8512
290,1,28243000,3,38739,1,18319211,01/11/2022,20.9,87042,45232,41810,26414,12958,13456
291,2,46208000,2,62332,2,29972868,01/11/2022,11.2,86901,45620,41281,26262,13160,13102
292,1,27925000,3,23555,1,18127695,01/11/2022,18.8,30519,15931,14588,10809,5325,5484
293,2,41389000,2,63243,2,26839607,01/11/2022,16.2,60811,31893,28918,19713,9706,10007
294,1,4599000,3,13567,1,2975783,01/11/2022,15.2,61510,31765,29745,21000,10487,10513
295,2,29705000,3,50338,2,19257912,01/11/2022,18.8,70042,36241,33801,21818,10809,11009
296,1,5669000,3,13695,1,3671155,01/11/2022,20.2,24662,12965,11697,6937,3350,3587
297,1,8180000,3,31516,1,5285484,01/11/2022,15.2,15414,7999,7415,4635,2291,2344
298,2,30699000,3,22403,2,19931947,01/11/2022,17.5,71528,37497,34031,23278,11539,11739
299,1,2816000,3,22049,1,1808351,01/11/2022,18.8,15249,7932,7317,4894,2453,2441
300,2,34300000,3,23899,2,22271101,01/11/2022,18.2,39425,20578,18847,13203,6477,6726
301,1,4347000,3,21935,1,2803615,01/11/2022,20.2,17293,8766,8527,5650,2795,2855
302,1,16114000,3,23089,1,10451011,01/11/2022,11.2,16905,8772,8133,5514,2740,2774
303,1,4741000,3,22387,1,3059263,01/11/2022,16.2,18097,9360,8737,5881,2892,2989
304,1,16749000,3,23899,1,10862951,01/11/2022,19.6,32333,16690,15643,10314,5057,5257
305,1,22708000,3,25184,1,14735016,01/11/2022,18.2,49940,25545,24395,16071,7998,8073
306,1,20949000,3,28059,1,13588791,01/11/2022,18,1049,546,503,282,149,133
307,1,17760000,3,28759,1,11515241,01/11/2022,18.7,6853,3584,3269,2311,1149,1162
308,1,10083000,3,5049,1,6548901,01/11/2022,27.4,12262,6119,6143,4251,2104,2147
309,1,3636000,3,28671,1,2334729,01/11/2022,18.2,11086,5609,5477,3615,1780,1835
310,1,4427000,3,27809,1,2849741,01/11/2022,20.9,13821,7083,6738,3938,1966,1972
311,2,57976000,1,161043,2,37523357,01/11/2022,22.3,341029,180370,160659,82444,40670,41774
312,2,84428000,1,107749,2,54770451,01/11/2022,21.5,157336,82380,74956,43883,21497,22386
313,1,28785000,3,20853,1,18689397,01/11/2022,24.3,174629,91268,83361,46521,22880,23641
314,2,34768000,2,52700,2,22546500,01/11/2022,24.1,104461,54150,50311,30967,15315,15652
315,1,18314000,3,49334,1,11854766,01/11/2022,21.3,44353,23038,21315,13070,6400,6670
316,1,5822000,3,24796,1,3759504,01/11/2022,25.3,21375,11206,10169,5662,2753,2909
317,2,40594000,3,42633,2,26343467,01/11/2022,25.9,17777,9225,8552,4254,2086,2168
318,2,46247000,2,100613,2,29959937,01/11/2022,24.9,64084,32934,31150,19785,9668,10117
319,1,17607000,3,23510,1,11421040,01/11/2022,24.7,20434,10867,9567,5939,2970,2969
320,1,17257000,3,28375,1,11188675,01/11/2022,18,19085,9763,9322,6343,3119,3224
321,3,114254000,1,118102,3,74146998,01/11/2022,19.5,371387,192530,178857,106784,52432,54352
322,1,26034000,3,21195,1,16900905,01/11/2022,23.8,18023,9240,8783,5154,2503,2651
323,1,16541000,3,45144,1,10706506,01/11/2022,21.3,20322,10479,9843,6201,3025,3176
324,1,23038000,3,31729,1,14942971,01/11/2022,21.3,25477,13300,12177,8208,4059,4149
325,1,10856000,2,56782,1,6999618,01/11/2022,24.8,13620,7015,6605,4098,1994,2104
326,1,13314000,3,25625,1,8628475,01/11/2022,21.3,48170,25016,23154,15515,7657,7858
327,1,10864000,3,46274,1,7015326,01/11/2022,27.2,10593,5340,5253,3485,1705,1780
328,2,42929000,2,71740,2,27832110,01/11/2022,23.8,8730,4395,4335,2894,1447,1447
329,1,5242000,3,23233,1,3384067,01/11/2022,25.1,14678,7367,7311,4863,2405,2458
330,1,9547000,3,25727,1,6179823,01/11/2022,23.8,10935,5450,5485,3532,1706,1826
331,1,12091000,3,26466,1,7832684,01/11/2022,26.5,19976,10345,9631,6431,3120,3311
332,2,71324000,2,104443,2,46256157,01/11/2022,18.3,412199,209241,202958,82879,40585,42294
333,2,69187000,1,119934,2,44851616,01/11/2022,18.5,304052,152635,151417,84118,41457,42661
334,3,103560000,1,128946,3,67185054,01/11/2022,17.5,536436,267279,269157,158598,77797,80801
335,3,137320000,1,155060,3,89102940,01/11/2022,17.5,635862,320627,315235,153834,75737,78097
336,3,172872000,1,252450,3,112114350,01/11/2022,20.2,1142952,578172,564780,270109,132170,137939
338,1,20407000,3,35575,1,13228975,01/11/2022,17.5,75721,38037,37684,21903,10795,11108
339,1,21049000,3,38273,1,13643577,01/11/2022,20.6,70378,35870,34508,21367,10464,10903
340,2,53608000,3,27884,2,34817316,01/11/2022,14.1,308285,152976,155309,108145,53196,54949
342,2,47906000,2,59094,2,31079806,01/11/2022,17.9,234698,115478,119220,87040,43098,43942
343,1,15233000,3,27491,1,9873959,01/11/2022,17.5,28843,14318,14525,8529,4190,4339
344,1,14897000,3,24365,1,9658685,01/11/2022,18.7,33522,17126,16396,9330,4711,4619
345,1,19429000,3,46947,1,12581903,01/11/2022,19.2,54467,27606,26861,15858,7789,8069
346,1,18837000,3,20875,1,12223175,01/11/2022,18.3,13059,6525,6534,4137,2073,2064
347,1,1367000,3,4437,1,884113,01/11/2022,14.1,9934,4952,4982,3082,1558,1524
348,1,5311000,3,24794,1,3427356,01/11/2022,14.1,7844,4131,3713,2621,1355,1266
349,1,10564000,3,47528,1,6819072,01/11/2022,17.5,48069,23121,24948,16392,8040,8352
350,1,13831000,3,26400,1,8963750,01/11/2022,18.5,11583,5810,5773,3713,1872,1841
351,1,5635000,3,22652,1,3640098,01/11/2022,26.6,29903,15539,14364,9778,4798,4980
352,3,168108000,1,240718,3,109029482,01/11/2022,23.2,258913,138803,120110,68042,33683,34359
353,2,58293000,2,84474,2,37805976,01/11/2022,25.7,103609,54904,48705,31555,15575,15980
354,2,33414000,2,77824,2,21641276,01/11/2022,29.1,76660,40113,36547,21596,10646,10950
355,2,46412000,3,47255,2,30120545,01/11/2022,28.1,88280,46038,42242,25864,12608,13256
356,2,36020000,3,51543,2,23361457,01/11/2022,21,56163,29689,26474,18214,8872,9342
357,1,3255000,3,28473,1,2087277,01/11/2022,25.7,7263,3837,3426,2540,1279,1261
358,1,16609000,3,23973,1,10771877,01/11/2022,28.2,16645,8759,7886,5075,2484,2591
359,1,17806000,3,48879,1,11525021,01/11/2022,24.3,31469,16729,14740,9837,4899,4938
360,1,15676000,3,26475,1,10162925,01/11/2022,15.5,12729,6935,5794,4541,2296,2245
361,1,14844000,3,24106,1,9624494,01/11/2022,28.1,26015,13735,12280,7360,3633,3727
362,2,51268000,3,34819,2,33289381,01/11/2022,26.6,29903,15539,14364,9778,4798,4980
363,2,31937000,3,39474,2,20719576,01/11/2022,27.4,10504,5405,5099,3440,1722,1718
364,1,19131000,3,24154,1,12410996,01/11/2022,29.1,45134,23442,21692,13494,6690,6804
365,2,29819000,3,32387,2,19349963,01/11/2022,19.8,29130,15431,13699,9957,5019,4938
366,1,5991000,3,19834,1,3874316,01/11/2022,25,5812,3105,2707,1767,906,861
367,1,16553000,3,28802,1,10730648,01/11/2022,15.5,15851,8463,7388,5625,2839,2786
368,1,5285000,3,46210,1,3389040,01/11/2022,19.8,15298,8185,7113,4499,2268,2231
369,2,31546000,3,28336,2,20476564,01/11/2022,28.1,17525,9370,8155,5075,2488,2587
370,1,23043000,2,70148,1,14907802,01/11/2022,15.5,18915,10248,8667,6395,3217,3178
371,1,25098000,3,21827,1,16291873,01/11/2022,21.4,81848,43535,38313,23849,11894,11955
372,2,42762000,3,43234,2,27752066,01/11/2022,20.5,33726,17513,16213,11096,5372,5724
373,1,2791000,3,33106,1,1781044,01/11/2022,19.8,11168,5931,5237,3889,1954,1935
374,1,6091000,3,24709,1,3934441,01/11/2022,25.7,6341,3343,2998,2049,979,1070
375,1,23923000,3,20065,1,15529885,01/11/2022,21.4,45895,23816,22079,12162,5997,6165
376,1,7079000,3,39328,1,4562022,01/11/2022,24.8,6863,3664,3199,2612,1321,1291
377,1,11793000,3,28888,1,7636562,01/11/2022,20.5,10611,5602,5009,3876,1871,2005
378,1,3745000,3,21705,1,2412545,01/11/2022,28.2,14226,7514,6712,4380,2214,2166
379,1,5035000,3,23697,1,3249053,01/11/2022,21.4,7997,4114,3883,2359,1161,1198
380,1,4654000,3,11337,1,3013763,01/11/2022,24.3,4188,2243,1945,1509,761,748
381,2,32461000,2,56827,2,21042823,01/11/2022,26.6,15373,8115,7258,5203,2638,2565
382,1,20458000,3,30607,1,13267093,01/11/2022,28.7,14071,7408,6663,4497,2251,2246
383,1,2510000,3,20585,1,1610915,01/11/2022,14.6,6642,3720,2922,2058,1005,1053
384,1,9475000,3,6510,1,6152240,01/11/2022,26.4,11054,5638,5416,3563,1745,1818
385,3,247833000,1,466472,3,160624978,01/11/2022,16.9,1542232,806262,735970,402209,198130,204079
386,2,52391000,2,70400,2,33983750,01/11/2022,15.9,78264,40929,37335,23163,11368,11795
387,2,73993000,2,103738,2,47991712,01/11/2022,20.1,293825,155300,138525,93203,46206,46997
388,2,32542000,2,60447,2,21091853,01/11/2022,24.3,49578,26095,23483,16381,8171,8210
389,2,42512000,2,54307,2,27578493,01/11/2022,19.6,89314,47398,41916,25892,12760,13132
390,2,51859000,3,46119,2,33662231,01/11/2022,17.4,31315,16320,14995,10348,5100,5248
391,1,20097000,3,46543,1,13016507,01/11/2022,12.5,39203,20881,18322,12964,6446,6518
392,1,24955000,3,49358,1,16171392,01/11/2022,17.6,58957,31503,27454,19229,9506,9723
393,2,42247000,2,88976,2,27371574,01/11/2022,15.2,62849,33939,28910,17954,8876,9078
394,1,23106000,3,35332,1,14983568,01/11/2022,14.4,25468,13582,11886,8293,4136,4157
395,1,24770000,2,62025,1,16038475,01/11/2022,12.5,31599,16595,15004,11708,5967,5741
396,2,33489000,3,46254,2,21721596,01/11/2022,12.5,29123,15247,13876,9589,4733,4856
397,1,19143000,3,24086,1,12418864,01/11/2022,14.7,18110,9443,8667,6325,3046,3279
398,1,14213000,3,44778,1,9193672,01/11/2022,12.5,31695,16422,15273,11280,5582,5698
399,1,19391000,3,35314,1,12568836,01/11/2022,12.5,95322,48884,46438,32521,16133,16388
400,1,18008000,3,24649,1,11680551,01/11/2022,12.5,9358,5013,4345,2738,1323,1415
401,1,13904000,3,51705,1,8985895,01/11/2022,14.8,9149,4948,4201,2691,1357,1334
402,1,3579000,3,22049,1,2304301,01/11/2022,12.5,9913,5282,4631,3496,1711,1785
403,1,12962000,3,12853,1,8412447,01/11/2022,12.5,36620,18819,17801,10303,4961,5342
404,1,2062000,3,21661,1,1318639,01/11/2022,12.5,5276,2719,2557,1830,893,937
405,1,20139000,3,23089,1,13067261,01/11/2022,12.5,41455,21994,19461,13993,6843,7150
406,1,18133000,3,23856,1,11762594,01/11/2022,16.7,29613,15403,14210,9414,4672,4742
408,1,11706000,3,24028,1,7584872,01/11/2022,16.8,13922,7166,6756,5211,2590,2621
409,1,3487000,3,20867,1,2245683,01/11/2022,12.5,10960,5789,5171,3556,1785,1771
410,1,14723000,3,23089,1,9546861,01/11/2022,11.7,22904,12086,10818,7644,3743,3901
411,1,8094000,3,24787,1,5236313,01/11/2022,12.5,11776,6077,5699,3730,1832,1898
412,1,1961000,3,8759,1,1265891,01/11/2022,12.5,16797,8560,8237,5425,2652,2773
413,1,4130000,3,22645,1,2661855,01/11/2022,12.5,19648,10052,9596,6751,3334,3417
414,1,15580000,3,24028,1,10102972,01/11/2022,24.3,19341,10302,9039,6428,3158,3270
415,1,3395000,3,22859,1,2183891,01/11/2022,14.9,11487,6208,5279,3749,1855,1894
416,1,7235000,3,17105,1,4685645,01/11/2022,12.5,5703,2985,2718,1959,971,988
417,1,2019000,3,19989,1,1292361,01/11/2022,12.5,6644,3435,3209,2305,1130,1175
418,1,3592000,3,19247,1,2315553,01/11/2022,12.5,7491,3982,3509,2583,1266,1317
419,1,2153000,3,14051,1,1385399,01/11/2022,12.5,8481,4360,4121,2849,1391,1458
420,1,25904000,3,37197,1,16800403,01/11/2022,17.2,46996,24240,22756,12187,6012,6175
421,1,3188000,3,21785,1,2050415,01/11/2022,19.9,8445,4468,3977,3005,1505,1500
422,1,7241000,3,23336,1,4683314,01/11/2022,15.9,5612,3027,2585,1851,938,913
423,1,8341000,3,24246,1,5397404,01/11/2022,24.7,5276,2719,2557,1830,893,937
424,3,199687000,1,252966,3,129543584,01/11/2022,18.8,794789,407239,387550,199480,98049,101431
425,2,47911000,2,66785,2,31075365,01/11/2022,15.6,177719,91525,86194,50219,24680,25539
426,1,21250000,3,26485,1,13786015,01/11/2022,15.6,34955,18206,16749,9854,4805,5049
427,1,2183000,3,23204,1,1395746,01/11/2022,15.7,115264,60166,55098,28758,14392,14366
428,1,15550000,3,23341,1,10084159,01/11/2022,15.6,16795,8697,8098,5436,2628,2808
429,1,7007000,3,23434,1,4531116,01/11/2022,18.7,13390,6831,6559,4033,1966,2067
430,1,10484000,3,37055,1,6777545,01/11/2022,18.7,7953,4224,3729,2375,1195,1180
431,1,8430000,3,18500,1,5461000,01/11/2022,22.3,15512,8121,7391,5093,2493,2600
432,2,64392000,2,53406,2,41801394,01/11/2022,27.6,169028,86790,82238,45879,22689,23190
433,3,165595000,1,176214,3,107460536,01/11/2022,28.1,888797,441181,447616,247410,121384,126026
434,2,75388000,2,76528,2,48925672,01/11/2022,26,304942,149380,155562,85665,42398,43267
435,2,29734000,2,62807,2,19264293,01/11/2022,28.2,84519,42292,42227,24955,12440,12515
436,1,19979000,3,31784,1,12954566,01/11/2022,26.3,30754,15948,14806,10320,5221,5099
437,3,154070000,1,170213,3,99975287,01/11/2022,17.9,845941,437370,408571,227808,112567,115241
438,2,63016000,2,64656,2,40895744,01/11/2022,23.5,136351,71718,64633,38918,19062,19856
439,2,35578000,2,62671,2,23063029,01/11/2022,18.8,86686,44901,41785,27406,13467,13939
440,2,38011000,3,47410,2,24659740,01/11/2022,21.7,58158,30570,27588,17715,8934,8781
441,2,33961000,2,62054,2,22012596,01/11/2022,21.1,24258,12834,11424,7258,3602,3656
442,1,13018000,3,26115,1,8435585,01/11/2022,22.8,24454,12691,11763,7326,3576,3750
443,1,24006000,3,29191,1,15574709,01/11/2022,17.3,310192,159130,151062,94872,46787,48085
444,1,2923000,3,27348,1,1872602,01/11/2022,18.8,14340,7646,6694,4731,2430,2301
445,2,70446000,2,74142,2,45715758,01/11/2022,22.8,15341,8078,7263,4842,2416,2426
446,1,5004000,3,22655,1,3229945,01/11/2022,21.1,8045,4283,3762,2501,1247,1254
447,1,12626000,3,24838,1,8182062,01/11/2022,21.1,6644,3540,3104,2086,1058,1028
448,1,4154000,3,21846,1,2678254,01/11/2022,22.8,16582,8647,7935,5030,2477,2553
449,2,30302000,2,81071,2,19615229,01/11/2022,24.5,30796,15740,15056,9239,4503,4736
450,2,84397000,2,90889,2,54767161,01/11/2022,22.2,77849,40866,36983,21990,10871,11119
451,2,43214000,3,46979,2,28042121,01/11/2022,22.7,65215,33971,31244,19700,9733,9967
452,3,142099000,1,170417,3,92193933,01/11/2022,22.5,441975,227109,214866,122010,60145,61865
453,3,565994000,1,291937,3,367604163,01/11/2022,25.4,808416,416251,392165,234633,115277,119356
454,3,102878000,1,162756,3,66707944,01/11/2022,22.5,298009,154344,143665,83869,41238,42631
455,1,18988000,3,23679,1,12318521,01/11/2022,26.6,33924,17240,16684,10629,5267,5362
456,1,13568000,3,32435,1,8786765,01/11/2022,24,14772,7516,7256,4444,2199,2245
457,1,23728000,3,32789,1,15390411,01/11/2022,23.5,19742,9908,9834,6831,3367,3464
458,1,14088000,3,30297,1,9126903,01/11/2022,21.7,12848,6693,6155,3711,1831,1880
459,1,13076000,3,27953,1,8471447,01/11/2022,20.6,5457,2839,2618,1473,755,718
460,1,8122000,3,28386,1,5250914,01/11/2022,20.3,5926,3043,2883,1700,842,858
461,1,12808000,3,31625,1,8293575,01/11/2022,26.6,17097,8801,8296,5359,2662,2697
462,1,16625000,3,51209,1,10755041,01/11/2022,24.5,28239,14113,14126,8795,4312,4483
463,1,13912000,3,22993,1,9019807,01/11/2022,23,16934,8502,8432,5395,2626,2769
464,1,18308000,3,48846,1,11851354,01/11/2022,21.9,11851,5973,5878,3739,1841,1898
465,1,8124000,3,28702,1,5251898,01/11/2022,22.2,25157,12582,12575,8765,4230,4535
466,1,4062000,3,21631,1,2618669,01/11/2022,21.7,6055,3107,2948,1652,803,849
467,1,3835000,3,22394,1,2470356,01/11/2022,22.2,22421,11364,11057,6263,3134,3129
468,1,2030000,3,22279,1,1297221,01/11/2022,23,9864,5093,4771,3123,1529,1594
469,1,3822000,3,17283,1,2467017,01/11/2022,24.1,7888,4037,3851,3058,1509,1549
470,1,5886000,3,22279,1,3803621,01/11/2022,20.6,5524,2885,2639,1817,894,923
472,1,3399000,3,23835,1,2185515,01/11/2022,22.1,10328,5288,5040,3690,1794,1896
473,1,1254000,3,21455,1,793645,01/11/2022,24.1,4810,2229,2581,1556,759,797
474,3,104666000,1,166737,3,67866163,01/11/2022,21,329404,168547,160857,90108,44605,45503
475,3,195114000,1,290862,3,126533238,01/11/2022,19.3,855563,431621,423942,240318,117646,122672
476,2,43171000,2,78675,2,27982475,01/11/2022,17.9,117253,59414,57839,33098,16300,16798
477,2,73184000,2,64426,2,47505174,01/11/2022,16.9,176685,87738,88947,53884,26504,27380
478,2,81315000,1,123002,2,52731748,01/11/2022,13,261137,131158,129979,84004,41439,42565
479,2,44567000,2,52120,2,28916430,01/11/2022,20.6,120926,61958,58968,34805,17098,17707
480,2,29786000,3,39398,2,19321502,01/11/2022,16.6,67604,34141,33463,21101,10330,10771
481,1,15441000,3,23265,1,10013385,01/11/2022,19.3,38886,19733,19153,11641,5731,5910
482,1,19322000,3,25181,1,12534119,01/11/2022,19.1,30324,15540,14784,8298,4088,4210
483,2,30978000,3,41767,2,20093933,01/11/2022,11.9,91029,45722,45307,30379,15003,15376
484,1,25833000,3,31812,1,16759638,01/11/2022,17,62301,30877,31424,20494,10127,10367
485,1,2587000,3,22049,1,1659501,01/11/2022,18.7,12987,6460,6527,4296,2156,2140
486,1,15615000,3,26329,1,10123421,01/11/2022,12.2,38113,19225,18888,12385,6138,6247
487,1,2328000,3,26100,1,1487100,01/11/2022,18.8,12372,6340,6032,3845,1851,1994
488,1,14600000,3,29604,1,9460396,01/11/2022,17.1,39474,19169,20305,14904,7336,7568
489,1,15893000,3,23101,1,10307349,01/11/2022,15.8,30429,15578,14851,9786,4826,4960
490,1,5592000,3,26329,1,3608471,01/11/2022,19,13153,6653,6500,4059,2009,2050
491,1,5832000,3,23238,1,3767562,01/11/2022,13.2,11440,5836,5604,4121,2095,2026
492,1,2829000,3,21989,1,1816861,01/11/2022,14.4,4787,2437,2350,1357,684,673
493,3,117817000,1,166971,3,76414079,01/11/2022,25.4,340060,178122,161938,86078,42456,43622
494,2,58242000,3,42850,2,37814450,01/11/2022,26,43035,22773,20262,11996,6054,5942
495,1,27794000,3,35155,1,18030945,01/11/2022,27,27182,14325,12857,8434,4220,4214
496,1,17210000,3,22745,1,11163755,01/11/2022,26,21003,10909,10094,6452,3209,3243
497,1,28118000,3,40414,1,18236286,01/11/2022,27.1,31435,16316,15119,9125,4445,4680
498,1,23397000,3,40961,1,15167089,01/11/2022,26.5,29068,15153,13915,8638,4280,4358
499,1,20338000,3,24717,1,13194983,01/11/2022,26.9,25555,13197,12358,7191,3479,3712
500,1,8813000,3,22486,1,5705964,01/11/2022,26.2,13944,7272,6672,4420,2177,2243
501,1,25824000,3,29104,1,16756496,01/11/2022,26.9,34946,17956,16990,11208,5422,5786
502,1,16659000,3,30992,1,10797358,01/11/2022,26.7,16679,8618,8061,4633,2284,2349
503,2,73419000,2,82538,2,47639812,01/11/2022,23.9,297373,155718,141655,71865,35366,36499
504,3,179191000,1,200607,3,116273543,01/11/2022,20.7,691557,348387,343170,213267,104895,108372
505,2,87511000,2,74293,2,56807857,01/11/2022,18.9,416055,211059,204996,132268,65355,66913
506,1,21715000,3,34553,1,14080197,01/11/2022,22.6,111314,55902,55412,35576,17423,18153
507,2,78864000,2,96143,2,51165457,01/11/2022,21.5,332100,171749,160351,94911,46503,48408
508,2,39154000,3,51563,2,25398537,01/11/2022,23.5,79515,41903,37612,21445,10720,10725
509,2,34835000,2,67750,2,22575000,01/11/2022,23.5,205933,107685,98248,49242,24249,24993
510,1,15157000,3,22745,1,9829305,01/11/2022,19.8,48172,24667,23505,15031,7399,7632
511,1,10709000,3,25118,1,6935732,01/11/2022,22.6,18592,8945,9647,4116,2046,2070
512,2,38585000,3,36103,2,25044147,01/11/2022,24.1,79824,40689,39135,24808,12213,12595
513,1,2626000,3,20349,1,1686551,01/11/2022,22.6,10327,5388,4939,2996,1506,1490
514,1,9947000,3,19635,1,6445915,01/11/2022,22.6,28215,14347,13868,9384,4582,4802
515,1,7710000,3,6599,1,5004901,01/11/2022,23.6,10993,5737,5256,3544,1803,1741
517,2,30044000,3,38172,2,19490428,01/11/2022,14.2,53373,27810,25563,15744,7755,7989
518,2,41917000,2,80065,2,27165985,01/11/2022,17.8,13555,7357,6198,3051,1547,1504
519,2,30785000,3,36775,2,19973475,01/11/2022,13.6,59871,31271,28600,19112,9469,9643
520,2,56009000,2,76506,2,36329344,01/11/2022,16.2,47632,25410,22222,12563,6265,6298
521,1,22997000,3,32258,1,14915792,01/11/2022,17,45587,23716,21871,14000,6913,7087
522,1,16008000,3,24043,1,10381157,01/11/2022,13.4,37704,19683,18021,12453,6131,6322
523,1,16548000,3,18943,1,10737257,01/11/2022,14.2,70224,35655,34569,24421,12033,12388
524,1,3869000,3,41441,1,2473409,01/11/2022,14.2,17978,9382,8596,6248,3105,3143
525,1,2222000,3,24226,1,1420074,01/11/2022,14.2,13401,6929,6472,4288,2149,2139
526,1,1772000,3,16020,1,1135780,01/11/2022,14.2,30417,15670,14747,9405,4719,4686
527,1,8343000,3,29856,1,5393094,01/11/2022,14.2,28657,14853,13804,9078,4552,4526
528,1,1598000,3,11450,1,1027250,01/11/2022,14.2,1583,826,757,480,230,250
529,2,64580000,2,93739,2,41883261,01/11/2022,21.7,139075,74465,64610,36819,18286,18533
530,2,78717000,1,108204,2,51057846,01/11/2022,19.4,120500,65043,55457,29046,14403,14643
531,2,81995000,2,55397,2,53241353,01/11/2022,24.3,101336,54039,47297,24763,12096,12667
532,3,165084000,1,320608,3,106983992,01/11/2022,25.1,405952,215818,190134,89205,43880,45325
533,2,68884000,1,126244,2,44648356,01/11/2022,25.6,212540,111746,100794,51580,25268,26312
534,2,73497000,1,129130,2,47643920,01/11/2022,24.6,180057,96347,83710,45301,22589,22712
535,2,85420000,1,221164,2,55301836,01/11/2022,18.9,443063,237967,205096,110147,54509,55638
536,1,27779000,3,25529,1,18030821,01/11/2022,21.8,33226,17650,15576,10241,5095,5146
537,1,13296000,3,25175,1,8617225,01/11/2022,25.9,15512,8193,7319,4859,2440,2419
538,2,53262000,2,61291,2,34559009,01/11/2022,22.8,64445,34215,30230,17692,8626,9066
539,2,46191000,3,48634,2,29975516,01/11/2022,25.9,48567,25769,22798,13570,6693,6877
540,1,28194000,3,24761,1,18301339,01/11/2022,13.2,42451,22342,20109,14824,7241,7583
541,1,22038000,3,27773,1,14296927,01/11/2022,23.7,41588,21739,19849,12522,6161,6361
543,1,25817000,3,49653,1,16731397,01/11/2022,24.6,55452,29697,25755,14940,7380,7560
544,1,1902000,3,20606,1,1215694,01/11/2022,25.1,6076,3180,2896,1703,844,859
545,2,51511000,2,64245,2,33417905,01/11/2022,24.6,64692,34002,30690,19678,9778,9900
546,1,5199000,3,27164,1,3352186,01/11/2022,25.3,22760,12125,10635,6420,3229,3191
547,1,19073000,3,35412,1,12362038,01/11/2022,24.6,25608,13480,12128,7723,3870,3853
548,1,13387000,3,50723,1,8650827,01/11/2022,22.8,15733,8506,7227,4079,2054,2025
549,1,9531000,3,25864,1,6169286,01/11/2022,19.4,41785,22480,19305,10854,5445,5409
550,1,12020000,3,33050,1,7779950,01/11/2022,24.7,13225,6946,6279,3476,1669,1807
551,1,16788000,3,37362,1,10874838,01/11/2022,18.1,28655,15243,13412,8764,4302,4462
552,1,8564000,3,34651,1,5531949,01/11/2022,23.9,17727,9423,8304,4199,2068,2131
553,1,16499000,2,89651,1,10634699,01/11/2022,25.9,8969,4883,4086,2821,1444,1377
554,1,13381000,3,23692,1,8673958,01/11/2022,28.4,16758,8967,7791,4993,2542,2451
555,2,38376000,3,46397,2,24898003,01/11/2022,25.2,47035,25085,21950,12872,6289,6583
556,1,22426000,3,32299,1,14544601,01/11/2022,25.3,55720,29557,26163,14521,7123,7398
557,1,24812000,3,28680,1,16099120,01/11/2022,23.3,46909,24866,22043,15156,7483,7673
558,1,14233000,3,28975,1,9222475,01/11/2022,23.3,33986,17827,16159,9043,4421,4622
559,1,16702000,3,34308,1,10821992,01/11/2022,19.4,34847,18666,16181,8943,4380,4563
560,1,14960000,3,36846,1,9687154,01/11/2022,25.2,14304,7545,6759,4455,2182,2273
561,1,9609000,3,27828,1,6218022,01/11/2022,24.3,20797,10995,9802,4991,2418,2573
562,1,20778000,3,34897,1,13470803,01/11/2022,25.3,30232,15727,14505,8913,4281,4632
563,2,32357000,2,69501,2,20962549,01/11/2022,24.7,20165,10621,9544,5395,2701,2694
564,1,2924000,3,19722,1,1880878,01/11/2022,24.6,20380,10692,9688,6259,3127,3132
565,1,14551000,3,27804,1,9430346,01/11/2022,13.5,21640,11976,9664,7433,3885,3548
566,1,24305000,3,34984,1,15763266,01/11/2022,16.2,33402,17876,15526,9753,4761,4992
567,1,27040000,3,44985,1,17531015,01/11/2022,23,26236,13620,12616,8067,3962,4105
568,1,4361000,3,21279,1,2813371,01/11/2022,25.7,4405,2358,2047,1451,735,716
569,1,4528000,3,22859,1,2920341,01/11/2022,24.9,13716,7109,6607,3981,1920,2061
570,1,12692000,3,26795,1,8223005,01/11/2022,25.2,5653,2987,2666,1709,826,883
571,1,11689000,3,34496,1,7563354,01/11/2022,23.5,21318,11472,9846,5688,2873,2815
572,1,14056000,3,23521,1,9112879,01/11/2022,25.2,14582,7621,6961,4539,2262,2277
573,1,1920000,3,28775,1,1219225,01/11/2022,25.4,6219,3311,2908,1883,941,942
574,1,11363000,3,32373,1,7353577,01/11/2022,25,31856,17018,14838,8563,4318,4245
575,1,24942000,3,23322,1,16188978,01/11/2022,19.4,35893,18883,17010,11399,5600,5799
576,1,20410000,3,30282,1,13236218,01/11/2022,23.5,19272,10328,8944,5163,2534,2629
577,1,20084000,3,29512,1,13025088,01/11/2022,13.6,16364,8711,7653,5250,2654,2596
578,1,11796000,3,25801,1,7641599,01/11/2022,25.1,2820,1449,1371,720,341,379
579,1,2707000,3,20591,1,1738959,01/11/2022,26.3,4654,2510,2144,1296,630,666
580,1,1831000,3,22006,1,1168144,01/11/2022,13.6,21585,11243,10342,6456,3197,3259
581,1,1774000,3,22515,1,1130585,01/11/2022,25.2,6888,3543,3345,1840,922,918
582,1,2068000,3,24746,1,1319454,01/11/2022,24.9,21391,11404,9987,5619,2742,2877
583,1,1874000,3,22178,1,1195922,01/11/2022,25.3,9668,5030,4638,2384,1141,1243
584,1,22218000,3,24732,1,14416968,01/11/2022,25,13995,7311,6684,4212,2070,2142
585,1,5063000,3,22651,1,3268299,01/11/2022,25.3,6838,3583,3255,1791,891,900
586,1,1885000,3,22178,1,1203072,01/11/2022,24.9,5681,3058,2623,1606,823,783
587,1,9442000,3,26458,1,6110842,01/11/2022,13.6,13966,7679,6287,3739,1859,1880
588,1,14057000,3,19644,1,9117406,01/11/2022,25.6,28076,14773,13303,7550,3752,3798
589,1,6917000,3,27957,1,4468093,01/11/2022,11.5,34039,18008,16031,8858,4334,4524
590,1,2101000,3,18909,1,1346741,01/11/2022,19.4,15807,8231,7576,5949,2955,2994
591,1,1324000,3,14258,1,846342,01/11/2022,25.3,10581,5508,5073,2907,1418,1489
592,1,5036000,3,25053,1,3248347,01/11/2022,17.5,9554,4935,4619,2707,1302,1405
593,1,16193000,2,76271,1,10449179,01/11/2022,23.3,9988,5342,4646,2237,1127,1110
594,1,2381000,3,14180,1,1533470,01/11/2022,24.8,7578,3984,3594,2088,1031,1057
595,1,3156000,3,22859,1,2028541,01/11/2022,18.9,8005,4106,3899,2599,1296,1303
596,1,3226000,3,21975,1,2074925,01/11/2022,25.6,24085,12288,11797,7909,3780,4129
597,1,5057000,3,22486,1,3264564,01/11/2022,24.9,7455,4054,3401,2223,1145,1078
598,1,1346000,3,8676,1,866224,01/11/2022,25.4,17919,9538,8381,4548,2298,2250
599,1,6469000,3,24506,1,4180344,01/11/2022,24.6,15305,8066,7239,4706,2332,2374
600,3,175269000,1,254354,3,113670496,01/11/2022,27.3,921771,479309,442462,222551,109790,112761
601,1,17780000,3,21829,1,11535171,01/11/2022,24.4,26081,13338,12743,7626,3791,3835
602,2,37774000,3,21227,2,24531873,01/11/2022,27.5,56494,29131,27363,17460,8617,8843
603,1,22354000,3,23899,1,14506201,01/11/2022,26.3,52593,26982,25611,16883,8307,8576
604,1,6939000,3,29874,1,4480476,01/11/2022,27,41965,21110,20855,11192,5453,5739
605,1,11134000,3,28169,1,7208931,01/11/2022,26.8,26175,13553,12622,8885,4301,4584
606,1,16065000,3,26910,1,10415340,01/11/2022,25.4,35183,17868,17315,10650,5230,5420
607,1,12216000,3,26660,1,7913740,01/11/2022,24.2,56409,28489,27920,16919,8292,8627
608,1,11710000,3,14407,1,7597093,01/11/2022,24.3,139753,70456,69297,45077,22298,22779
609,1,9927000,3,23503,1,6429047,01/11/2022,26.3,17841,9042,8799,5372,2677,2695
610,1,10160000,3,20644,1,6583356,01/11/2022,24.3,28461,14574,13887,9148,4533,4615
611,2,42607000,2,63642,2,27630908,01/11/2022,16.5,143281,73905,69376,47529,23519,24010
612,2,47215000,1,106574,2,30583176,01/11/2022,14.5,138444,72335,66109,38201,18773,19428
613,1,14440000,3,24475,1,9361525,01/11/2022,16.4,22295,11690,10605,8176,4115,4061
614,1,15044000,3,47005,1,9731595,01/11/2022,15.2,25068,12776,12292,8673,4237,4436
615,1,3766000,3,22423,1,2425477,01/11/2022,16.8,15291,7886,7405,5051,2477,2574
616,1,5826000,3,22623,1,3764277,01/11/2022,15.5,38193,19467,18726,13775,6896,6879
617,1,12602000,3,24028,1,8167272,01/11/2022,16.7,46132,23831,22301,13972,6871,7101
618,1,2309000,3,21935,1,1478915,01/11/2022,20.6,13641,7027,6614,4307,2133,2174
1,2,93774000,1,174536,2,60778564,01/10/2022,20,863893,444725,419168,260350,128225,132125
2,1,15455000,3,24834,1,10020916,01/10/2022,20.4,31963,16433,15530,11390,5609,5781
3,1,9374000,3,22023,1,6071077,01/10/2022,17.5,63805,32406,31399,23397,11652,11745
4,1,8781000,3,22383,1,5685267,01/10/2022,20.4,21049,10874,10175,7097,3529,3568
5,1,4846000,3,20491,1,3129409,01/10/2022,17.5,32035,16367,15668,10989,5374,5615
6,3,200864000,1,235157,3,130326443,01/10/2022,28.3,854186,425977,428209,227917,112151,115766
7,3,396412000,1,506629,3,257161171,01/10/2022,20.9,1810645,899293,911352,503963,246971,256992
8,2,86208000,2,90895,2,55944305,01/10/2022,18.1,330652,167339,163313,86895,42903,43992
9,2,33056000,3,26024,2,21460376,01/10/2022,20,81059,40420,40639,23492,11470,12022
10,2,34059000,3,48206,2,22090144,01/10/2022,20.5,100660,49935,50725,28067,13772,14295
11,1,17128000,3,25298,1,11107902,01/10/2022,26.3,19081,9476,9605,5934,2909,3025
12,2,76501000,1,116661,2,49608989,01/10/2022,27.3,250141,126245,123896,65670,32312,33358
13,2,56562000,2,78245,2,36687055,01/10/2022,25.3,136285,66083,70202,42780,21001,21779
14,2,74818000,1,105933,2,48525767,01/10/2022,27.5,202694,98608,104086,64935,31858,33077
15,1,24719000,3,32396,1,16034954,01/10/2022,24.2,43805,22160,21645,13050,6507,6543
16,1,23540000,2,65687,1,15235313,01/10/2022,27.1,16311,8010,8301,4984,2435,2549
17,1,9797000,3,24163,1,6343887,01/10/2022,25.6,14357,6822,7535,3854,1925,1929
18,1,2959000,3,26801,1,1896549,01/10/2022,20.4,13596,6842,6754,4196,2086,2110
19,1,9032000,3,24132,1,5846668,01/10/2022,22.2,13596,6842,6754,4196,2086,2110
20,1,3479000,3,28344,1,2233006,01/10/2022,24.9,7185,3509,3676,2099,1015,1084
21,2,41270000,2,63103,2,26762397,01/10/2022,27.4,191238,97313,93925,52600,25862,26738
22,2,40517000,2,58104,2,26277946,01/10/2022,27.1,249623,130524,119099,66498,32635,33863
23,1,25287000,3,23470,1,16413080,01/10/2022,28.2,31375,16375,15000,10682,5317,5365
24,1,18028000,3,25598,1,11692602,01/10/2022,27.2,35799,18291,17508,11962,5883,6079
25,1,11224000,3,31251,1,7264349,01/10/2022,28,15949,8217,7732,4538,2234,2304
26,2,77445000,2,85038,2,50254212,01/10/2022,27.4,217550,113613,103937,65123,32048,33075
27,2,46952000,3,42189,2,30476611,01/10/2022,17.5,183509,96930,86579,60413,30246,30167
28,2,49178000,2,68926,2,31896774,01/10/2022,20.1,113479,60064,53415,36594,18199,18395
29,2,99307000,2,82931,2,64466619,01/10/2022,25.4,578830,303756,275074,166456,82025,84431
30,2,36425000,3,43872,2,23632378,01/10/2022,27,51797,27093,24704,17614,8812,8802
31,2,55178000,1,124008,2,35741692,01/10/2022,24.9,38087,20017,18070,11916,5833,6083
32,1,13343000,3,20774,1,8652176,01/10/2022,28.6,32109,16780,15329,10495,5074,5421
33,1,22939000,3,21392,1,14888958,01/10/2022,23.7,21727,11415,10312,7786,3890,3896
34,1,14069000,3,26755,1,9118095,01/10/2022,25.4,49201,25651,23550,16539,8102,8437
35,1,20098000,3,35287,1,13028413,01/10/2022,24.6,37546,19668,17878,11791,5836,5955
36,1,21894000,2,74876,1,14156224,01/10/2022,19.6,47688,25247,22441,17870,8920,8950
37,1,4622000,3,22024,1,2982276,01/10/2022,27,55931,28786,27145,18430,9082,9348
38,1,11706000,3,31293,1,7577607,01/10/2022,23.4,29018,15064,13954,10291,5191,5100
39,1,9713000,3,36957,1,6276493,01/10/2022,24.6,18219,9592,8627,5806,2838,2968
40,1,11333000,3,25108,1,7341342,01/10/2022,26.7,15244,8058,7186,4848,2429,2419
41,1,5186000,3,21085,1,3349815,01/10/2022,29.2,25366,13345,12021,7752,3823,3929
42,1,17455000,3,22179,1,11323571,01/10/2022,27.3,19271,9996,9275,6517,3095,3422
43,1,4459000,3,19498,1,2878852,01/10/2022,28.3,7662,4073,3589,2321,1153,1168
44,1,989000,3,0,1,642850,01/10/2022,20.2,20044,10360,9684,7602,3787,3815
45,3,303649000,1,258273,3,197113577,01/10/2022,16.7,1501551,750157,751394,459910,225614,234296
46,3,111464000,1,182895,3,72268705,01/10/2022,18.6,925762,474776,450986,250961,123448,127513
47,2,30415000,3,50852,2,19718898,01/10/2022,21,128548,65838,62710,37721,18411,19310
48,1,24338000,3,42016,1,15777684,01/10/2022,15.7,135586,69677,65909,41627,20458,21169
49,2,32360000,2,60440,2,20973560,01/10/2022,18.2,113843,59214,54629,34117,16974,17143
50,1,5135000,3,26130,1,3311620,01/10/2022,23.7,23140,11693,11447,7155,3499,3656
51,1,8895000,3,23278,1,5758472,01/10/2022,17.6,35087,17902,17185,11563,5663,5900
52,1,13205000,3,31862,1,8551388,01/10/2022,19.3,42019,21548,20471,12599,6234,6365
53,1,10462000,3,29679,1,6770621,01/10/2022,21.7,22066,11231,10835,6719,3420,3299
54,1,8492000,3,22779,1,5497021,01/10/2022,11.8,17410,9121,8289,6393,3204,3189
55,1,1805000,3,21292,1,1151958,01/10/2022,19.6,22568,11549,11019,7200,3540,3660
56,1,6515000,3,22102,1,4212648,01/10/2022,13.8,15054,7516,7538,5557,2768,2789
57,1,3733000,2,69254,1,2357196,01/10/2022,16.5,8253,4210,4043,2801,1419,1382
58,1,4845000,3,21033,1,3128217,01/10/2022,12.8,7834,4065,3769,2439,1200,1239
59,1,1881000,3,21237,1,1201413,01/10/2022,10.2,14755,7617,7138,4907,2427,2480
60,1,12933000,3,33527,1,8372923,01/10/2022,16.2,62038,31762,30276,19262,9511,9751
61,3,100413000,1,122161,3,65146289,01/10/2022,22.8,690193,353744,336449,203574,99881,103693
62,3,135749000,1,177141,3,88059709,01/10/2022,17.5,864431,434753,429678,267728,131619,136109
63,2,42317000,2,79934,2,27426116,01/10/2022,23.4,237169,119538,117631,71348,35023,36325
64,2,49237000,2,65129,2,31938921,01/10/2022,26.7,173959,86825,87134,55826,27459,28367
65,1,10008000,3,23385,1,6481815,01/10/2022,22.1,39058,19755,19303,11201,5479,5722
66,3,109863000,1,160707,3,71250243,01/10/2022,20.9,59762,30506,29256,20025,9931,10094
67,1,14505000,3,35635,1,9392615,01/10/2022,21.5,49490,25496,23994,16916,8460,8456
68,1,28784000,2,53406,1,18656194,01/10/2022,22.1,160225,79799,80426,53549,26489,27060
69,1,14779000,3,20853,1,9585497,01/10/2022,18.5,114010,56192,57818,38156,18905,19251
70,1,24568000,3,36420,1,15932780,01/10/2022,20.7,75242,37695,37547,23792,11778,12014
71,1,12655000,3,22547,1,8203203,01/10/2022,21.7,59196,29915,29281,18125,8949,9176
72,1,14830000,3,23972,1,9615528,01/10/2022,22.7,32704,16713,15991,11320,5572,5748
73,1,6368000,3,24532,1,4114668,01/10/2022,22.1,23413,11884,11529,7157,3552,3605
74,1,10855000,3,24592,1,7031158,01/10/2022,21.8,38992,19602,19390,13022,6299,6723
75,1,1744000,3,27717,1,1105883,01/10/2022,22.9,27314,13703,13611,9005,4397,4608
76,2,56136000,2,68954,2,36419446,01/10/2022,24.3,146965,75962,71003,46271,22786,23485
77,2,30966000,3,41304,2,20086596,01/10/2022,30.3,88337,44762,43575,34686,17254,17432
78,2,40415000,2,66278,2,26203472,01/10/2022,29.4,159853,80569,79284,57402,28064,29338
79,1,2737000,3,21215,1,1757835,01/10/2022,26.2,9746,4912,4834,3336,1602,1734
80,1,2342000,3,25815,1,1496485,01/10/2022,28.5,15368,7632,7736,5699,2779,2920
81,1,1347000,3,7831,1,867719,01/10/2022,27.3,147496,76348,71148,49524,24280,25244
82,1,1089000,3,22642,1,685208,01/10/2022,27.5,14892,7420,7472,5365,2615,2750
83,1,8058000,3,24006,1,5213694,01/10/2022,22.1,34798,17459,17339,10865,5211,5654
84,2,40041000,1,179092,2,25847558,01/10/2022,18.8,432205,227255,204950,86717,42372,44345
85,2,40842000,1,179185,2,26368115,01/10/2022,18.8,759003,398068,360935,168014,83097,84917
86,2,95239000,1,332591,2,61572759,01/10/2022,20.2,1173351,609477,563874,261635,129105,132530
87,1,27519000,2,62605,1,17824745,01/10/2022,19,414470,219003,195467,75588,37198,38390
88,1,19236000,2,57875,1,12445525,01/10/2022,15.7,186693,97615,89078,46165,22603,23562
89,3,159522000,1,374905,3,103314395,01/10/2022,18.8,1835486,947835,887651,451632,222341,229291
90,2,49433000,1,120417,2,32011033,01/10/2022,19.1,614447,325337,289110,113945,55951,57994
91,1,26955000,2,91096,1,17429654,01/10/2022,18.6,434153,232032,202121,62030,30612,31418
92,2,54295000,1,134702,2,35157048,01/10/2022,18.1,323771,167274,156497,83659,40990,42669
93,2,45202000,2,100811,2,29280489,01/10/2022,17,404695,212343,192352,85496,42058,43438
94,1,28183000,1,154646,1,18164304,01/10/2022,18.7,443704,233586,210118,95713,47173,48540
95,2,62472000,1,255296,2,40351504,01/10/2022,18.3,545884,284933,260951,101794,50260,51534
96,1,14379000,2,59192,1,9287158,01/10/2022,17.4,429481,220393,209088,105785,52018,53767
97,1,8045000,3,44274,1,5184976,01/10/2022,14.2,246428,128767,117661,58169,28791,29378
98,1,11686000,3,35381,1,7560519,01/10/2022,14.2,599935,314284,285651,130174,64060,66114
99,3,119105000,1,150457,3,77267793,01/10/2022,18.4,616068,317266,298802,191866,94056,97810
100,2,69399000,2,94963,2,45014387,01/10/2022,16.3,301742,154079,147663,97495,48007,49488
101,1,9111000,3,17412,1,5904738,01/10/2022,20.5,96243,49040,47203,29383,14345,15038
102,1,15400000,3,33591,1,9976409,01/10/2022,20.2,30063,15334,14729,10450,5151,5299
103,1,1561000,2,91399,1,923251,01/10/2022,27,3222,1654,1568,1247,637,610
104,1,11608000,2,56466,1,7488734,01/10/2022,17,17967,9205,8762,6003,2945,3058
105,1,2211000,3,19820,1,1417330,01/10/2022,17.3,11943,6311,5632,3854,1993,1861
106,1,1915000,2,98213,1,1146537,01/10/2022,19.8,12850,6538,6312,4678,2267,2411
107,2,37357000,1,105148,2,24176902,01/10/2022,12.2,26678,13733,12945,10032,4897,5135
108,3,165050000,1,255446,3,107027054,01/10/2022,15.2,223876,119352,104524,50306,24928,25378
109,2,57698000,1,186075,2,37317625,01/10/2022,15.9,515353,266081,249272,126007,61695,64312
110,2,96607000,1,319726,2,62474824,01/10/2022,17.2,776220,402522,373698,193769,95439,98330
111,2,58271000,2,91858,2,37784292,01/10/2022,16.6,84298,43745,40553,23019,11356,11663
112,2,44946000,2,52448,2,29162452,01/10/2022,17.7,30929,15848,15081,8319,4034,4285
113,2,29903000,1,131957,2,19304993,01/10/2022,16.4,293245,152241,141004,70657,34731,35926
114,2,55602000,1,202570,2,35938730,01/10/2022,15.8,658907,338453,320454,150053,73914,76139
115,1,24348000,3,29675,1,15796525,01/10/2022,15.8,117995,60165,57830,29983,14851,15132
116,3,160435000,1,339602,3,103943148,01/10/2022,15.3,1643623,845932,797691,437489,216020,221469
117,2,71666000,1,157466,2,46425434,01/10/2022,19,368585,190133,178452,107535,52900,54635
118,2,43725000,2,69416,2,28351834,01/10/2022,10.2,174704,91497,83207,54449,28355,26094
119,1,19523000,3,43924,1,12646026,01/10/2022,7.8,2931,1520,1411,975,512,463
120,2,52202000,1,110073,2,33821227,01/10/2022,10,35491,18986,16505,7987,3993,3994
121,2,62443000,1,152474,2,40435476,01/10/2022,16.6,703215,359601,343614,230612,113552,117060
122,2,59065000,1,177693,2,38214557,01/10/2022,17.4,18226,9300,8926,5308,2603,2705
123,2,47205000,2,78133,2,30605117,01/10/2022,17.7,1072676,556998,515678,265425,131078,134347
124,1,21423000,3,23083,1,13901867,01/10/2022,20.3,14038,7254,6784,3763,1910,1853
125,2,66756000,2,96004,2,43295396,01/10/2022,10.2,174704,91497,83207,54449,28355,26094
126,2,51058000,3,37465,2,33150235,01/10/2022,15.4,7077,3593,3484,1748,893,855
127,2,35782000,3,51406,2,23206894,01/10/2022,17.7,53362,27304,26058,15169,7515,7654
128,1,16369000,3,20550,1,10619300,01/10/2022,6.2,24612,12254,12358,7339,3541,3798
129,2,46012000,1,167193,2,29740607,01/10/2022,16.9,10873,5623,5250,3757,1878,1879
130,2,55299000,2,58837,2,35885513,01/10/2022,14.1,23219,12339,10880,6425,3186,3239
131,1,25676000,3,33453,1,16655947,01/10/2022,16.6,12671,6512,6159,3454,1710,1744
132,1,20263000,3,30164,1,13140786,01/10/2022,15.2,30967,16277,14690,10756,5327,5429
133,2,38263000,3,50569,2,24820381,01/10/2022,16.4,323545,166328,157217,93932,46757,47175
134,1,6874000,3,22915,1,4445185,01/10/2022,20.8,19326,10155,9171,6252,3129,3123
135,1,20329000,3,34156,1,13179694,01/10/2022,10.2,33716,17686,16030,9317,4624,4693
136,1,12352000,2,56168,1,7972632,01/10/2022,15.8,40279,20716,19563,10282,5078,5204
137,1,4168000,3,20061,1,2689139,01/10/2022,16.6,29068,14916,14152,8580,4220,4360
138,1,25943000,2,54467,1,16808483,01/10/2022,17.5,12752,6694,6058,3471,1768,1703
139,1,3939000,3,45190,1,2515160,01/10/2022,14.4,33166,16973,16193,9497,4707,4790
140,1,7114000,3,14374,1,4609726,01/10/2022,15.8,52828,27143,25685,16500,8128,8372
141,2,29503000,3,25901,2,19151049,01/10/2022,16.1,32738,16941,15797,9059,4431,4628
142,1,10364000,3,23400,1,6713200,01/10/2022,16.6,30203,15792,14411,7568,3777,3791
143,2,29306000,3,33617,2,19015283,01/10/2022,15.8,11760,6069,5691,3432,1700,1732
144,1,9596000,3,23122,1,6214278,01/10/2022,17.7,72525,37076,35449,22128,10944,11184
145,1,9055000,3,25318,1,5860432,01/10/2022,7.8,18580,9729,8851,5724,2801,2923
146,1,17831000,3,28722,1,11561428,01/10/2022,17.4,24575,12798,11777,7126,3453,3673
147,1,1306000,3,21773,1,827127,01/10/2022,16.4,44731,22925,21806,13335,6514,6821
148,1,8279000,3,50013,1,5331337,01/10/2022,15.9,658907,338453,320454,150053,73914,76139
149,1,13800000,3,24435,1,8945565,01/10/2022,17.5,10336,5387,4949,3449,1664,1785
150,1,12266000,3,22384,1,7950516,01/10/2022,13.6,4656,2421,2235,1533,751,782
151,1,6620000,3,26573,1,4276427,01/10/2022,16.4,9598,5002,4596,2910,1467,1443
152,1,10097000,3,25171,1,6537879,01/10/2022,15.8,15171,7853,7318,4470,2251,2219
153,1,6070000,3,26602,1,3918898,01/10/2022,16.6,10792,5577,5215,3492,1713,1779
154,1,1981000,3,2553,1,1285097,01/10/2022,15.8,37442,19141,18301,12089,5963,6126
155,1,3837000,3,21853,1,2472197,01/10/2022,10.2,17736,9182,8554,5577,2775,2802
156,1,7917000,3,11767,1,5134283,01/10/2022,17.4,386290,199249,187041,112223,55337,56886
157,1,9009000,3,28533,1,5827317,01/10/2022,17.4,9925,5218,4707,2833,1403,1430
158,1,8522000,3,22912,1,5516388,01/10/2022,20.3,6944,3666,3278,2341,1149,1192
159,1,6954000,3,28375,1,4491725,01/10/2022,15.3,88734,45471,43263,28316,14166,14150
160,1,8191000,3,25978,1,5298172,01/10/2022,10,6449,3346,3103,1687,833,854
161,1,6537000,3,27587,1,4221463,01/10/2022,14.9,10735,5576,5159,3010,1518,1492
162,1,3548000,3,21579,1,2284621,01/10/2022,10,10810,5614,5196,2941,1451,1490
163,1,1389000,3,956,1,901894,01/10/2022,24.9,13038,6614,6424,4157,2015,2142
165,3,170379000,1,222875,3,110523475,01/10/2022,21,1579803,804212,775591,594938,292494,302444
166,2,73425000,2,62884,2,47663366,01/10/2022,18,378143,194849,183294,128863,62806,66057
167,2,70183000,2,63931,2,45555019,01/10/2022,19.8,452090,230346,221744,162764,80177,82587
168,1,20553000,3,30846,1,13328604,01/10/2022,20.9,69371,35473,33898,25304,12303,13001
169,2,30332000,3,44439,2,19671361,01/10/2022,19.1,79772,40908,38864,30907,15312,15595
170,1,22151000,3,34128,1,14364022,01/10/2022,19.9,56597,29703,26894,19146,9514,9632
171,1,21906000,3,31430,1,14207470,01/10/2022,19,72663,38036,34627,27395,13712,13683
172,2,43491000,2,76921,2,28192229,01/10/2022,20.3,160682,83178,77504,52342,25860,26482
173,2,29485000,3,38163,2,19127087,01/10/2022,19.1,83352,42766,40586,32937,16375,16562
174,2,30347000,3,29590,2,19695960,01/10/2022,16.2,67101,35567,31534,27008,13393,13615
175,1,16908000,3,32435,1,10957765,01/10/2022,19.8,43249,22352,20897,17065,8284,8781
176,1,24940000,3,43630,1,16167370,01/10/2022,17.2,51894,27702,24192,20579,10113,10466
177,1,21794000,3,47677,1,14118423,01/10/2022,19.4,70068,36526,33542,21044,10402,10642
178,1,18957000,3,24105,1,12297945,01/10/2022,19.9,52156,27081,25075,17108,8394,8714
179,1,3578000,3,26755,1,2298945,01/10/2022,19.4,41910,21741,20169,12631,6146,6485
180,1,21317000,3,47978,1,13808072,01/10/2022,18.8,43998,23109,20889,17575,8775,8800
181,1,4643000,3,21578,1,2996372,01/10/2022,21.9,24757,12827,11930,9816,4898,4918
182,1,3711000,3,21936,1,2390214,01/10/2022,19.5,21756,11234,10522,8659,4317,4342
183,1,7911000,3,13647,1,5128503,01/10/2022,18.8,28109,14419,13690,10548,5187,5361
184,1,5598000,3,24066,1,3614634,01/10/2022,21,15305,7996,7309,5899,2872,3027
185,1,25074000,2,61212,1,16236888,01/10/2022,17.5,72452,38019,34433,23628,11618,12010
186,1,15688000,3,23293,1,10173907,01/10/2022,19.9,35401,18444,16957,12235,5945,6290
187,1,23753000,3,35450,1,15404000,01/10/2022,18.1,27593,14289,13304,10803,5260,5543
188,1,16922000,3,21636,1,10977664,01/10/2022,20.3,31264,16171,15093,9806,4840,4966
189,1,17198000,3,40238,1,11138462,01/10/2022,16,24228,12861,11367,9383,4674,4709
190,1,17977000,3,28508,1,11656542,01/10/2022,14.7,32831,17049,15782,13856,6706,7150
191,1,2567000,3,27150,1,1641400,01/10/2022,19.6,16092,8507,7585,6837,3451,3386
192,1,7266000,3,27590,1,4695310,01/10/2022,17.5,8011,4268,3743,3134,1562,1572
193,1,13436000,3,29384,1,8704016,01/10/2022,21,29002,14796,14206,11206,5550,5656
194,1,2681000,3,27408,1,1715242,01/10/2022,15.7,7946,4172,3774,3293,1607,1686
195,1,10548000,3,10738,1,6845462,01/10/2022,20.4,28260,14728,13532,11002,5473,5529
196,1,5888000,3,6425,1,3820775,01/10/2022,19.2,25845,13471,12374,9370,4627,4743
197,3,133414000,1,203470,3,86515630,01/10/2022,28.6,658609,345979,312630,183298,90145,93153
198,2,52668000,2,55261,2,34178939,01/10/2022,23.2,225728,119129,106599,71494,35347,36147
199,2,32047000,3,41070,2,20789480,01/10/2022,31.8,70760,36613,34147,21788,10705,11083
200,2,42104000,2,77655,2,27289945,01/10/2022,25.3,132854,69610,63244,41183,20301,20882
201,1,17677000,2,70958,1,11419092,01/10/2022,20.6,50399,26542,23857,14000,6918,7082
202,1,2920000,3,27316,1,1870684,01/10/2022,22.1,27944,14419,13525,9490,4664,4826
203,1,6098000,3,25417,1,3938283,01/10/2022,20.5,22534,11802,10732,7926,3939,3987
204,1,12812000,3,29316,1,8298484,01/10/2022,26.6,25148,13436,11712,8928,4476,4452
205,1,24221000,3,27599,1,15716051,01/10/2022,21.9,33783,18241,15542,12201,6089,6112
206,2,30882000,3,26154,2,20047146,01/10/2022,27.9,25850,13268,12582,8390,4048,4342
208,2,32913000,3,41824,2,21351626,01/10/2022,19.3,27607,14605,13002,9883,5002,4881
209,1,8381000,3,24901,1,5422749,01/10/2022,26.6,13866,7187,6679,4383,2099,2284
210,1,6902000,3,28542,1,4457758,01/10/2022,26.8,23363,12127,11236,7776,3818,3958
211,1,15814000,3,25712,1,10253388,01/10/2022,25.3,18224,9500,8724,7072,3514,3558
212,1,13213000,3,29966,1,8558484,01/10/2022,28.4,16447,8464,7983,4843,2381,2462
213,1,5875000,3,14021,1,3804729,01/10/2022,23.9,17550,9283,8267,5700,2861,2839
214,2,65237000,1,152389,2,42251661,01/10/2022,17,297848,156299,141549,74787,37046,37741
215,1,26769000,3,32468,1,17367382,01/10/2022,18.9,29390,15521,13869,7939,3942,3997
216,2,31947000,2,66600,2,20698950,01/10/2022,18.3,37608,20094,17514,11115,5490,5625
217,2,38032000,2,66138,2,24654662,01/10/2022,17.6,106163,56161,50002,30752,15034,15718
218,1,13245000,3,21970,1,8587280,01/10/2022,15.7,11149,5894,5255,2996,1479,1517
219,2,35428000,2,52498,2,22975702,01/10/2022,15.1,60265,30945,29320,18808,9224,9584
220,1,18619000,3,32919,1,12069431,01/10/2022,19.1,17718,9411,8307,4913,2492,2421
221,1,17615000,3,31987,1,11417763,01/10/2022,18.1,36618,19077,17541,10530,5273,5257
222,1,12087000,3,24098,1,7832452,01/10/2022,16.9,9853,5224,4629,2757,1390,1367
223,1,2641000,3,24460,1,1692190,01/10/2022,17.9,27713,14561,13152,7736,3885,3851
224,1,6439000,3,20826,1,4164524,01/10/2022,18,32276,17014,15262,9457,4578,4879
225,1,8497000,3,21370,1,5501680,01/10/2022,16.9,14689,7582,7107,4123,2033,2090
226,2,38597000,3,43583,2,25044467,01/10/2022,25.2,44311,23331,20980,13756,6771,6985
227,1,4184000,3,22024,1,2697576,01/10/2022,21.2,14732,7791,6941,4911,2433,2478
228,1,11687000,3,23725,1,7572825,01/10/2022,17,20530,10890,9640,6356,3180,3176
229,1,12201000,3,21292,1,7909358,01/10/2022,24.4,16368,8558,7810,4728,2323,2405
230,1,8319000,3,23256,1,5384094,01/10/2022,14.7,6213,3216,2997,1786,871,915
231,1,9858000,3,23891,1,6383809,01/10/2022,15.1,28792,15288,13504,8327,4111,4216
232,1,5204000,3,28552,1,3354048,01/10/2022,17.1,29472,15519,13953,9890,4934,4956
233,1,5085000,3,6731,1,3298519,01/10/2022,16.8,8657,4501,4156,2464,1200,1264
234,2,67806000,2,103079,2,43970821,01/10/2022,26.2,224166,112147,112019,65088,31954,33134
235,2,29157000,2,73766,2,18878284,01/10/2022,19.6,111569,57370,54199,36412,17892,18520
236,1,24993000,3,32282,1,16213168,01/10/2022,21.1,38780,20122,18658,13025,6461,6564
237,3,152789000,1,337119,3,98975731,01/10/2022,20,1385621,718628,666993,333198,164217,168981
238,3,102504000,1,248599,3,66379001,01/10/2022,20,1257547,645398,612149,321993,158559,163434
239,1,20060000,3,27690,1,13011310,01/10/2022,22.1,37871,19554,18317,11359,5732,5627
240,2,86453000,1,206328,2,55988122,01/10/2022,23,650123,329365,320758,200033,98558,101475
241,2,41646000,2,65061,2,27004839,01/10/2022,22.1,111975,57735,54240,31481,15460,16021
242,1,13500000,3,24406,1,8750594,01/10/2022,21.1,98842,50427,48415,30938,15263,15675
243,2,64813000,1,195602,2,41932848,01/10/2022,20.4,44103,22420,21683,15768,7755,8013
244,1,10606000,3,26490,1,6867410,01/10/2022,18.2,53539,27205,26334,18000,8916,9084
245,1,10712000,3,25393,1,6937407,01/10/2022,28.5,18787,9476,9311,6502,3270,3232
246,1,16842000,3,38788,1,10908512,01/10/2022,21.1,59648,30609,29039,19344,9536,9808
247,2,52373000,2,95648,2,33946802,01/10/2022,22.1,30471,15635,14836,9610,4654,4956
248,1,4279000,3,21494,1,2759856,01/10/2022,20.7,20286,10307,9979,6804,3413,3391
249,1,4323000,3,20208,1,2789742,01/10/2022,22.5,20345,10131,10214,6733,3300,3433
250,1,19202000,3,37352,1,12443948,01/10/2022,20.7,31115,15891,15224,10525,5240,5285
251,1,12589000,3,43397,1,8139453,01/10/2022,20.7,16550,8456,8094,5252,2552,2700
252,1,16668000,3,24009,1,10810191,01/10/2022,22.1,24352,12627,11725,8092,4062,4030
253,1,19515000,3,42804,1,12641946,01/10/2022,19.2,94978,48709,46269,29794,14672,15122
254,1,24309000,3,26861,1,15773989,01/10/2022,25.1,52019,26739,25280,15725,7759,7966
255,1,3936000,3,24876,1,2533524,01/10/2022,20.5,24580,12765,11815,8215,4057,4158
256,1,14425000,3,24547,1,9351703,01/10/2022,22.4,28678,14679,13999,9074,4497,4577
257,1,4255000,3,20826,1,2744924,01/10/2022,15.9,22738,11719,11019,7000,3537,3463
258,1,10951000,3,21149,1,7097001,01/10/2022,22.1,28145,14670,13475,8863,4390,4473
259,1,9440000,3,20380,1,6115620,01/10/2022,22.1,19113,9852,9261,5504,2716,2788
260,1,2331000,3,20596,1,1494554,01/10/2022,18.2,25925,13382,12543,8585,4189,4396
261,1,1077000,3,27150,1,672900,01/10/2022,22.4,13033,6697,6336,4420,2181,2239
262,1,3118000,3,20759,1,2005941,01/10/2022,10.5,5955,3118,2837,1972,974,998
263,1,1724000,3,21344,1,1099256,01/10/2022,20.7,8850,4524,4326,2773,1377,1396
264,1,2393000,3,19010,1,1536440,01/10/2022,15.9,9529,4943,4586,3018,1490,1528
265,1,9189000,3,33766,1,5939084,01/10/2022,18.2,14636,7533,7103,4910,2424,2486
266,1,17553000,3,35219,1,11374231,01/10/2022,20.7,40906,20800,20106,12864,6409,6455
267,1,6142000,3,24265,1,3968035,01/10/2022,22.1,8142,4289,3853,2686,1333,1353
268,1,2198000,3,26762,1,1401938,01/10/2022,15.9,7954,4060,3894,2570,1274,1296
269,1,10934000,3,23274,1,7083826,01/10/2022,20.7,17000,8527,8473,5215,2549,2666
270,1,3405000,3,26806,1,2186444,01/10/2022,17.8,14424,7439,6985,5399,2678,2721
271,1,2678000,3,20720,1,1719980,01/10/2022,20.7,16873,8725,8148,6022,3008,3014
272,1,2867000,3,17449,1,1846101,01/10/2022,22.1,5109,2618,2491,1631,805,826
273,1,2459000,3,21041,1,1577309,01/10/2022,22.1,13243,6795,6448,4043,1954,2089
274,1,2640000,3,20827,1,1695173,01/10/2022,18.2,14497,7627,6870,4260,2099,2161
275,1,2362000,3,18820,1,1516480,01/10/2022,21.3,16324,8373,7951,5562,2774,2788
276,1,5170000,3,21465,1,3339035,01/10/2022,27.6,9842,5047,4795,3323,1629,1694
277,1,2714000,3,20049,1,1744051,01/10/2022,18.2,27833,14525,13308,9097,4581,4516
278,1,4793000,3,6228,1,3109222,01/10/2022,21.2,33284,17172,16112,10804,5349,5455
279,1,2153000,3,21047,1,1378403,01/10/2022,23.6,14697,7601,7096,4740,2380,2360
280,1,3868000,3,20435,1,2493765,01/10/2022,19.2,18607,9363,9244,6403,3178,3225
284,3,102219000,1,159910,3,66282440,01/10/2022,18.5,743275,388114,355161,202467,99875,102592
285,2,41345000,2,88437,2,26785813,01/10/2022,18.2,154546,80401,74145,48513,24003,24510
286,2,69298000,1,108092,2,44935608,01/10/2022,20,299523,155411,144112,93845,46362,47483
287,2,46359000,2,79763,2,30053587,01/10/2022,29,83637,42325,41312,24783,12286,12497
288,2,33942000,2,75253,2,21987047,01/10/2022,29,102362,52461,49901,35162,17416,17746
289,1,16496000,3,31298,1,10691102,01/10/2022,19.9,55287,28877,26410,16959,8447,8512
290,1,21478000,3,36521,1,13924179,01/10/2022,21.8,87042,45232,41810,26414,12958,13456
291,2,37226000,2,59086,2,24137814,01/10/2022,12.5,86901,45620,41281,26262,13160,13102
292,1,21202000,3,22575,1,13758725,01/10/2022,19.9,30519,15931,14588,10809,5325,5484
293,2,30847000,3,37303,2,20013247,01/10/2022,17.2,60811,31893,28918,19713,9706,10007
294,1,3960000,3,12111,1,2561889,01/10/2022,16.4,61510,31765,29745,21000,10487,10513
295,1,20939000,3,50596,1,13559754,01/10/2022,19.2,70042,36241,33801,21818,10809,11009
296,1,4698000,3,12240,1,3041460,01/10/2022,20.3,24662,12965,11697,6937,3350,3587
297,1,6163000,3,19513,1,3986437,01/10/2022,16.4,15414,7999,7415,4635,2291,2344
298,1,22874000,3,21718,1,14846382,01/10/2022,17.8,71528,37497,34031,23278,11539,11739
299,1,1897000,3,21364,1,1211686,01/10/2022,19.9,15249,7932,7317,4894,2453,2441
300,1,26207000,3,22446,1,17012104,01/10/2022,18.4,39425,20578,18847,13203,6477,6726
301,1,3604000,3,21250,1,2321350,01/10/2022,20.3,17293,8766,8527,5650,2795,2855
302,1,11800000,3,22404,1,7647596,01/10/2022,12.5,16905,8772,8133,5514,2740,2774
303,1,3912000,3,27036,1,2515764,01/10/2022,17.2,18097,9360,8737,5881,2892,2989
304,1,12819000,3,22446,1,8309904,01/10/2022,20.4,32333,16690,15643,10314,5057,5257
305,1,17624000,3,28190,1,11427410,01/10/2022,19.2,49940,25545,24395,16071,7998,8073
306,1,16716000,3,25141,1,10840259,01/10/2022,19.3,1049,546,503,282,149,133
307,1,13834000,3,28074,1,8964026,01/10/2022,19.5,6853,3584,3269,2311,1149,1162
308,1,7214000,3,6025,1,4683075,01/10/2022,27.4,12262,6119,6143,4251,2104,2147
309,1,2420000,3,30198,1,1542802,01/10/2022,19.2,11086,5609,5477,3615,1780,1835
310,1,3045000,3,27565,1,1951685,01/10/2022,21.8,13821,7083,6738,3938,1966,1972
311,2,50880000,1,154374,2,32917626,01/10/2022,22.5,341029,180370,160659,82444,40670,41774
312,2,67329000,2,101675,2,43662175,01/10/2022,21.4,157336,82380,74956,43883,21497,22386
313,1,23033000,3,19400,1,14952050,01/10/2022,26.2,174629,91268,83361,46521,22880,23641
314,2,30355000,3,50020,2,19680730,01/10/2022,24.4,104461,54150,50311,30967,15315,15652
315,1,16039000,2,52382,1,10372968,01/10/2022,23.2,44353,23038,21315,13070,6400,6670
316,1,5218000,3,24534,1,3367166,01/10/2022,25.5,21375,11206,10169,5662,2753,2909
317,2,31940000,3,41951,2,20719049,01/10/2022,26,17777,9225,8552,4254,2086,2168
318,2,37522000,2,93296,2,24296004,01/10/2022,26.2,64084,32934,31150,19785,9668,10117
319,1,14750000,3,28288,1,9559212,01/10/2022,25.8,20434,10867,9567,5939,2970,2969
320,1,13524000,3,32636,1,8757964,01/10/2022,17.2,19085,9763,9322,6343,3119,3224
321,2,96899000,1,109867,2,62874483,01/10/2022,23.1,371387,192530,178857,106784,52432,54352
322,1,18980000,3,21195,1,12315805,01/10/2022,27.9,18023,9240,8783,5154,2503,2651
323,1,12784000,3,40373,1,8269227,01/10/2022,23.6,20322,10479,9843,6201,3025,3176
324,1,18259000,3,28836,1,11839514,01/10/2022,23.6,25477,13300,12177,8208,4059,4149
325,1,7249000,2,52185,1,4659665,01/10/2022,27.4,13620,7015,6605,4098,1994,2104
326,1,11862000,3,22558,1,7687742,01/10/2022,23.6,48170,25016,23154,15515,7657,7858
327,1,8229000,3,45345,1,5303505,01/10/2022,29.6,10593,5340,5253,3485,1705,1780
328,2,35892000,2,65920,2,23263880,01/10/2022,27.9,8730,4395,4335,2894,1447,1447
329,1,3844000,3,27380,1,2471220,01/10/2022,27.7,14678,7367,7311,4863,2405,2458
330,1,6480000,3,30232,1,4181768,01/10/2022,27.9,10935,5450,5485,3532,1706,1826
331,1,8701000,3,25055,1,5630595,01/10/2022,29,19976,10345,9631,6431,3120,3311
332,2,59730000,1,105891,2,38718609,01/10/2022,22.3,412199,209241,202958,82879,40585,42294
333,2,55789000,1,114314,2,36148536,01/10/2022,23.4,304052,152635,151417,84118,41457,42661
334,2,86112000,1,128836,2,55843964,01/10/2022,20.9,536436,267279,269157,158598,77797,80801
335,3,116120000,1,145144,3,75332856,01/10/2022,20.9,635862,320627,315235,153834,75737,78097
336,3,147790000,1,201394,3,95862106,01/10/2022,23.6,1142952,578172,564780,270109,132170,137939
338,1,16286000,3,29671,1,10556229,01/10/2022,20.9,75721,38037,37684,21903,10795,11108
339,1,17975000,3,33869,1,11649881,01/10/2022,24.1,70378,35870,34508,21367,10464,10903
340,2,44062000,3,25118,2,28615182,01/10/2022,15,308285,152976,155309,108145,53196,54949
342,2,40149000,2,60091,2,26036759,01/10/2022,20.4,234698,115478,119220,87040,43098,43942
343,1,12758000,3,25374,1,8267326,01/10/2022,20.9,28843,14318,14525,8529,4190,4339
344,1,11150000,3,22855,1,7224645,01/10/2022,22.5,33522,17126,16396,9330,4711,4619
345,1,15995000,3,44041,1,10352709,01/10/2022,22,54467,27606,26861,15858,7789,8069
346,1,14688000,3,19422,1,9527778,01/10/2022,22.3,13059,6525,6534,4137,2073,2064
347,1,1181000,3,2984,1,764666,01/10/2022,15,9934,4952,4982,3082,1558,1524
348,1,5028000,3,23341,1,3244859,01/10/2022,15,7844,4131,3713,2621,1355,1266
349,1,8892000,3,50580,1,5729220,01/10/2022,20.9,48069,23121,24948,16392,8040,8352
350,1,10829000,3,26138,1,7012712,01/10/2022,23.4,11583,5810,5773,3713,1872,1841
351,1,2766000,3,19613,1,1778287,01/10/2022,26.5,29903,15539,14364,9778,4798,4980
352,3,137459000,1,215549,3,89132801,01/10/2022,23.1,258913,138803,120110,68042,33683,34359
353,2,49333000,2,79345,2,31987105,01/10/2022,26.6,103609,54904,48705,31555,15575,15980
354,1,27569000,2,66963,1,17852887,01/10/2022,28.5,76660,40113,36547,21596,10646,10950
355,2,35003000,3,43823,2,22708127,01/10/2022,29.1,88280,46038,42242,25864,12608,13256
356,1,27657000,3,50314,1,17926736,01/10/2022,21.4,56163,29689,26474,18214,8872,9342
357,1,2332000,3,27020,1,1488780,01/10/2022,26.6,7263,3837,3426,2540,1279,1261
358,1,15735000,3,22540,1,10205210,01/10/2022,28.3,16645,8759,7886,5075,2484,2591
359,1,13887000,3,47164,1,8979386,01/10/2022,24.8,31469,16729,14740,9837,4899,4938
360,1,12642000,3,25022,1,8192278,01/10/2022,15.8,12729,6935,5794,4541,2296,2245
361,1,11463000,3,23665,1,7427285,01/10/2022,29.1,26015,13735,12280,7360,3633,3727
362,2,41438000,3,27050,2,26907650,01/10/2022,26.5,29903,15539,14364,9778,4798,4980
363,1,24909000,3,34187,1,16156663,01/10/2022,27.1,10504,5405,5099,3440,1722,1718
364,1,16647000,3,29111,1,10791439,01/10/2022,28.5,45134,23442,21692,13494,6690,6804
365,1,22337000,3,30249,1,14488801,01/10/2022,20.2,29130,15431,13699,9957,5019,4938
366,1,4299000,3,18381,1,2775969,01/10/2022,26.4,5812,3105,2707,1767,906,861
367,1,13497000,3,27349,1,8745701,01/10/2022,15.8,15851,8463,7388,5625,2839,2786
368,1,4844000,3,20725,1,3127875,01/10/2022,20.2,15298,8185,7113,4499,2268,2231
369,1,24778000,3,25430,1,16080270,01/10/2022,29.1,17525,9370,8155,5075,2488,2587
370,1,18986000,2,68695,1,12272205,01/10/2022,15.8,18915,10248,8667,6395,3217,3178
371,1,19949000,3,20374,1,12946476,01/10/2022,21.2,81848,43535,38313,23849,11894,11955
372,2,36577000,3,39735,2,23735315,01/10/2022,21.1,33726,17513,16213,11096,5372,5724
373,1,2343000,3,36241,1,1486709,01/10/2022,20.2,11168,5931,5237,3889,1954,1935
374,1,5388000,3,23256,1,3478944,01/10/2022,26.6,6341,3343,2998,2049,979,1070
375,1,20509000,3,17159,1,13313691,01/10/2022,21.2,45895,23816,22079,12162,5997,6165
376,1,5983000,3,37875,1,3851075,01/10/2022,25.2,6863,3664,3199,2612,1321,1291
377,1,9785000,3,27435,1,6332815,01/10/2022,21.1,10611,5602,5009,3876,1871,2005
378,1,3496000,3,21021,1,2251379,01/10/2022,28.3,14226,7514,6712,4380,2214,2166
379,1,4540000,3,22244,1,2928756,01/10/2022,21.2,7997,4114,3883,2359,1161,1198
380,1,3983000,3,11093,1,2577857,01/10/2022,24.8,4188,2243,1945,1509,761,748
381,1,26594000,3,50882,1,17235218,01/10/2022,26.5,15373,8115,7258,5203,2638,2565
382,1,17387000,3,20863,1,11280687,01/10/2022,28.3,14071,7408,6663,4497,2251,2246
383,1,1988000,3,19132,1,1273068,01/10/2022,15.1,6642,3720,2922,2058,1005,1053
384,1,5875000,3,5057,1,3813693,01/10/2022,25.9,11054,5638,5416,3563,1745,1818
385,3,212929000,1,404278,3,137999572,01/10/2022,18.3,1542232,806262,735970,402209,198130,204079
386,2,45652000,2,59750,2,29614050,01/10/2022,17,78264,40929,37335,23163,11368,11795
387,2,61675000,2,97680,2,39991070,01/10/2022,20,293825,155300,138525,93203,46206,46997
388,1,27510000,2,58489,1,17823011,01/10/2022,24.3,49578,26095,23483,16381,8171,8210
389,2,35022000,3,47286,2,22717014,01/10/2022,19.4,89314,47398,41916,25892,12760,13132
390,2,42797000,3,36358,2,27781692,01/10/2022,18.3,31315,16320,14995,10348,5100,5248
391,1,16857000,3,44749,1,10912301,01/10/2022,13.7,39203,20881,18322,12964,6446,6518
392,1,19942000,3,46592,1,12915708,01/10/2022,18,58957,31503,27454,19229,9506,9723
393,2,33495000,2,87315,2,21684435,01/10/2022,16.6,62849,33939,28910,17954,8876,9078
394,1,17306000,3,34135,1,11214765,01/10/2022,15,25468,13582,11886,8293,4136,4157
395,1,22245000,3,41371,1,14417879,01/10/2022,13.7,31599,16595,15004,11708,5967,5741
396,2,29607000,3,49751,2,19194799,01/10/2022,13.7,29123,15247,13876,9589,4733,4856
397,1,15329000,3,24378,1,9939472,01/10/2022,16.5,18110,9443,8667,6325,3046,3279
398,1,12965000,3,45492,1,8381758,01/10/2022,13.7,31695,16422,15273,11280,5582,5698
399,1,16280000,3,30909,1,10551091,01/10/2022,13.7,95322,48884,46438,32521,16133,16388
400,1,14468000,3,24696,1,9379504,01/10/2022,13.7,9358,5013,4345,2738,1323,1415
401,1,11067000,2,54292,1,7139258,01/10/2022,15.4,9149,4948,4201,2691,1357,1334
402,1,3485000,3,20596,1,2244654,01/10/2022,13.7,9913,5282,4631,3496,1711,1785
403,1,10720000,3,11384,1,6956616,01/10/2022,13.7,36620,18819,17801,10303,4961,5342
404,1,1804000,3,21043,1,1151557,01/10/2022,13.7,5276,2719,2557,1830,893,937
405,1,17061000,3,22404,1,11067246,01/10/2022,13.7,41455,21994,19461,13993,6843,7150
406,1,15315000,3,20904,1,9933846,01/10/2022,18.2,29613,15403,14210,9414,4672,4742
408,1,10117000,3,21635,1,6554415,01/10/2022,17.4,13922,7166,6756,5211,2590,2621
409,1,3222000,3,19008,1,2075292,01/10/2022,13.7,10960,5789,5171,3556,1785,1771
410,1,11128000,3,22471,1,7210729,01/10/2022,11.9,22904,12086,10818,7644,3743,3901
411,1,7385000,3,23334,1,4776916,01/10/2022,13.7,11776,6077,5699,3730,1832,1898
412,1,1490000,3,7306,1,961194,01/10/2022,13.7,16797,8560,8237,5425,2652,2773
413,1,2874000,3,27150,1,1840950,01/10/2022,13.7,19648,10052,9596,6751,3334,3417
414,1,13574000,3,23343,1,8799757,01/10/2022,24,19341,10302,9039,6428,3158,3270
415,1,3080000,3,22241,1,1979759,01/10/2022,14.5,11487,6208,5279,3749,1855,1894
416,1,5630000,3,15652,1,3643848,01/10/2022,13.7,5703,2985,2718,1959,971,988
417,1,1787000,3,18536,1,1143014,01/10/2022,13.7,6644,3435,3209,2305,1130,1175
418,1,3138000,3,22867,1,2016833,01/10/2022,13.7,7491,3982,3509,2583,1266,1317
419,1,2111000,3,12598,1,1359552,01/10/2022,13.7,8481,4360,4121,2849,1391,1458
420,1,22086000,3,33805,1,14322095,01/10/2022,18,46996,24240,22756,12187,6012,6175
421,1,2660000,3,19134,1,1709866,01/10/2022,20.7,8445,4468,3977,3005,1505,1500
422,1,5557000,3,21883,1,3590167,01/10/2022,16.1,5612,3027,2585,1851,938,913
423,1,7318000,3,24977,1,4731723,01/10/2022,25.4,5276,2719,2557,1830,893,937
424,3,177534000,1,243642,3,115153458,01/10/2022,19.2,794789,407239,387550,199480,98049,101431
425,2,42175000,2,69837,2,27343913,01/10/2022,16.3,177719,91525,86194,50219,24680,25539
426,1,18245000,3,23533,1,11835717,01/10/2022,16.3,34955,18206,16749,9854,4805,5049
427,1,2196000,3,20252,1,1407148,01/10/2022,16.1,115264,60166,55098,28758,14392,14366
428,1,14671000,3,27849,1,9508301,01/10/2022,16.3,16795,8697,8098,5436,2628,2808
429,1,6245000,3,20482,1,4038768,01/10/2022,19.2,13390,6831,6559,4033,1966,2067
430,1,9170000,3,28094,1,5932406,01/10/2022,19.2,7953,4224,3729,2375,1195,1180
431,1,7357000,3,19231,1,4762819,01/10/2022,23.1,15512,8121,7391,5093,2493,2600
432,2,53292000,3,49047,2,34590753,01/10/2022,28.8,169028,86790,82238,45879,22689,23190
433,3,146429000,1,164934,3,95013916,01/10/2022,29,888797,441181,447616,247410,121384,126026
434,2,65495000,2,70716,2,42501034,01/10/2022,26.8,304942,149380,155562,85665,42398,43267
435,1,24083000,2,59446,1,15594504,01/10/2022,26.9,84519,42292,42227,24955,12440,12515
436,1,14539000,3,29115,1,9421235,01/10/2022,27.5,30754,15948,14806,10320,5221,5099
437,3,127350000,1,136278,3,82641222,01/10/2022,18.3,845941,437370,408571,227808,112567,115241
438,2,52218000,2,58074,2,33883626,01/10/2022,25.2,136351,71718,64633,38918,19062,19856
439,1,25891000,2,77165,1,16751985,01/10/2022,19.6,86686,44901,41785,27406,13467,13939
440,1,28445000,3,45253,1,18443997,01/10/2022,22,58158,30570,27588,17715,8934,8781
441,1,25007000,2,63844,1,16190706,01/10/2022,26.1,24258,12834,11424,7258,3602,3656
442,1,11311000,3,30526,1,7321624,01/10/2022,25,24454,12691,11763,7326,3576,3750
443,1,20330000,3,25992,1,13188508,01/10/2022,17.4,310192,159130,151062,94872,46787,48085
444,1,2936000,3,32001,1,1876399,01/10/2022,18.9,14340,7646,6694,4731,2430,2301
445,2,54857000,2,67520,2,35589530,01/10/2022,25,15341,8078,7263,4842,2416,2426
446,1,3949000,3,26981,1,2539869,01/10/2022,26.1,8045,4283,3762,2501,1247,1254
447,1,9454000,3,23385,1,6121715,01/10/2022,26.1,6644,3540,3104,2086,1058,1028
448,1,4001000,3,20393,1,2580257,01/10/2022,25,16582,8647,7935,5030,2477,2553
449,1,24281000,2,79661,1,15702989,01/10/2022,29.6,30796,15740,15056,9239,4503,4736
450,2,62645000,2,84178,2,40635072,01/10/2022,29.2,77849,40866,36983,21990,10871,11119
451,2,33385000,3,46740,2,21653510,01/10/2022,27.5,65215,33971,31244,19700,9733,9967
452,3,111722000,1,149913,3,72469387,01/10/2022,26.3,441975,227109,214866,122010,60145,61865
453,3,435749000,1,262805,3,282974045,01/10/2022,30.5,808416,416251,392165,234633,115277,119356
454,2,78638000,1,129401,2,50985299,01/10/2022,29.1,298009,154344,143665,83869,41238,42631
455,1,15629000,3,20606,1,10138244,01/10/2022,30.3,33924,17240,16684,10629,5267,5362
456,1,11760000,3,31630,1,7612370,01/10/2022,28.3,14772,7516,7256,4444,2199,2245
457,1,18384000,3,29883,1,11919717,01/10/2022,27.7,19742,9908,9834,6831,3367,3464
458,1,11048000,3,28844,1,7152356,01/10/2022,28.2,12848,6693,6155,3711,1831,1880
459,1,10287000,3,27610,1,6658940,01/10/2022,25.9,5457,2839,2618,1473,755,718
460,1,6425000,3,28052,1,4148198,01/10/2022,25.7,5926,3043,2883,1700,842,858
461,1,10109000,3,29482,1,6541368,01/10/2022,30.3,17097,8801,8296,5359,2662,2697
462,1,13649000,3,45518,1,8826332,01/10/2022,29.6,28239,14113,14126,8795,4312,4483
463,1,11740000,3,21884,1,7609116,01/10/2022,28.5,16934,8502,8432,5395,2626,2769
464,1,14838000,3,46429,1,9598271,01/10/2022,28.1,11851,5973,5878,3739,1841,1898
465,1,6841000,3,23199,1,4423451,01/10/2022,28.1,25157,12582,12575,8765,4230,4535
466,1,3657000,3,26136,1,2350914,01/10/2022,27.8,6055,3107,2948,1652,803,849
467,1,3300000,3,20941,1,2124059,01/10/2022,28.1,22421,11364,11057,6263,3134,3129
468,1,2237000,3,20826,1,1433224,01/10/2022,28.5,9864,5093,4771,3123,1529,1594
469,1,3044000,3,20385,1,1958215,01/10/2022,27.5,7888,4037,3851,3058,1509,1549
470,1,4863000,3,21661,1,3139289,01/10/2022,25.9,5524,2885,2639,1817,894,923
472,1,3214000,3,18331,1,2070769,01/10/2022,27.4,10328,5288,5040,3690,1794,1896
473,1,881000,3,21305,1,551345,01/10/2022,27.5,4810,2229,2581,1556,759,797
474,2,81568000,1,141400,2,52877800,01/10/2022,27.4,329404,168547,160857,90108,44605,45503
475,3,161022000,1,255836,3,104408464,01/10/2022,26.3,855563,431621,423942,240318,117646,122672
476,2,33113000,2,76961,2,21446489,01/10/2022,25.3,117253,59414,57839,33098,16300,16798
477,2,64460000,2,57783,2,41841217,01/10/2022,27,176685,87738,88947,53884,26504,27380
478,2,68098000,1,115743,2,44147957,01/10/2022,19,261137,131158,129979,84004,41439,42565
479,2,36554000,3,49214,2,23710886,01/10/2022,27.1,120926,61958,58968,34805,17098,17707
480,1,25273000,3,32644,1,16394806,01/10/2022,24.8,67604,34141,33463,21101,10330,10771
481,1,12929000,3,23265,1,8380585,01/10/2022,25.8,38886,19733,19153,11641,5731,5910
482,1,13740000,3,26168,1,8904832,01/10/2022,25.8,30324,15540,14784,8298,4088,4210
483,1,25790000,3,33561,1,16729939,01/10/2022,17.4,91029,45722,45307,30379,15003,15376
484,1,22963000,3,29560,1,14896390,01/10/2022,25.7,62301,30877,31424,20494,10127,10367
485,1,3169000,3,20596,1,2039254,01/10/2022,21.2,12987,6460,6527,4296,2156,2140
486,1,13123000,3,28498,1,8501452,01/10/2022,17.7,38113,19225,18888,12385,6138,6247
487,1,2435000,3,23885,1,1558865,01/10/2022,25.7,12372,6340,6032,3845,1851,1994
488,1,12812000,3,26691,1,8301109,01/10/2022,24.8,39474,19169,20305,14904,7336,7568
489,1,13113000,3,22485,1,8500965,01/10/2022,23,30429,15578,14851,9786,4826,4960
490,1,4504000,3,24325,1,2903275,01/10/2022,26,13153,6653,6500,4059,2009,2050
491,1,5189000,3,22624,1,3350226,01/10/2022,23,11440,5836,5604,4121,2095,2026
492,1,2194000,3,26767,1,1399333,01/10/2022,24.7,4787,2437,2350,1357,684,673
493,2,95201000,1,156276,2,61724374,01/10/2022,25.8,340060,178122,161938,86078,42456,43622
494,2,45178000,3,40148,2,29325552,01/10/2022,27.2,43035,22773,20262,11996,6054,5942
495,1,21473000,3,32249,1,13925201,01/10/2022,27.3,27182,14325,12857,8434,4220,4214
496,1,14232000,3,21797,1,9229003,01/10/2022,27.2,21003,10909,10094,6452,3209,3243
497,1,21453000,3,36213,1,13908237,01/10/2022,27.5,31435,16316,15119,9125,4445,4680
498,1,16734000,3,39852,1,10837248,01/10/2022,26.7,29068,15153,13915,8638,4280,4358
499,1,16530000,3,22961,1,10721539,01/10/2022,27.8,25555,13197,12358,7191,3479,3712
500,1,7235000,3,21803,1,4680947,01/10/2022,26.9,13944,7272,6672,4420,2177,2243
501,1,19863000,3,26152,1,12884798,01/10/2022,27.1,34946,17956,16990,11208,5422,5786
502,1,12728000,3,32212,1,8240988,01/10/2022,26.8,16679,8618,8061,4633,2284,2349
503,2,59989000,2,76506,2,38916344,01/10/2022,26.2,297373,155718,141655,71865,35366,36499
504,3,147262000,1,187475,3,95532825,01/10/2022,24.4,691557,348387,343170,213267,104895,108372
505,2,77362000,2,65332,2,50219968,01/10/2022,23.5,416055,211059,204996,132268,65355,66913
506,1,18945000,3,30148,1,12284102,01/10/2022,24.3,111314,55902,55412,35576,17423,18153
507,2,65144000,2,85883,2,42257717,01/10/2022,23.5,332100,171749,160351,94911,46503,48408
508,2,29905000,3,48653,2,19389597,01/10/2022,26.2,79515,41903,37612,21445,10720,10725
509,2,31441000,2,67301,2,20369349,01/10/2022,25.6,205933,107685,98248,49242,24249,24993
510,1,12880000,3,21636,1,8350364,01/10/2022,25,48172,24667,23505,15031,7399,7632
511,1,8449000,3,23665,1,5468185,01/10/2022,24.3,18592,8945,9647,4116,2046,2070
512,2,31061000,3,37755,2,20151895,01/10/2022,26,79824,40689,39135,24808,12213,12595
513,1,2395000,3,18896,1,1537854,01/10/2022,24.3,10327,5388,4939,2996,1506,1490
514,1,7913000,3,20367,1,5123083,01/10/2022,24.3,28215,14347,13868,9384,4582,4802
515,1,5465000,3,6355,1,3545895,01/10/2022,25.8,10993,5737,5256,3544,1803,1741
517,1,25101000,3,41676,1,16273974,01/10/2022,14.1,53373,27810,25563,15744,7755,7989
518,2,33169000,2,72876,2,21486974,01/10/2022,18,13555,7357,6198,3051,1547,1504
519,1,26252000,3,38822,1,17024978,01/10/2022,15.1,59871,31271,28600,19112,9469,9643
520,2,43679000,2,68636,2,28322714,01/10/2022,16.6,47632,25410,22222,12563,6265,6298
521,1,18774000,3,30189,1,12172911,01/10/2022,18,45587,23716,21871,14000,6913,7087
522,1,12387000,3,29000,1,8022550,01/10/2022,14.3,37704,19683,18021,12453,6131,6322
523,1,14686000,3,19683,1,9526217,01/10/2022,14.1,70224,35655,34569,24421,12033,12388
524,1,3339000,3,19864,1,2150486,01/10/2022,14.1,17978,9382,8596,6248,3105,3143
525,1,1426000,3,22773,1,904127,01/10/2022,14.1,13401,6929,6472,4288,2149,2139
526,1,1615000,3,14630,1,1035120,01/10/2022,14.1,30417,15670,14747,9405,4719,4686
527,1,7527000,3,29856,1,4862694,01/10/2022,14.1,28657,14853,13804,9078,4552,4526
528,1,1253000,3,11206,1,803244,01/10/2022,14.1,1583,826,757,480,230,250
529,2,53416000,2,79313,2,34641087,01/10/2022,21.8,139075,74465,64610,36819,18286,18533
530,2,61026000,2,82319,2,39584581,01/10/2022,19.5,120500,65043,55457,29046,14403,14643
531,2,62379000,3,49582,2,40496768,01/10/2022,24.9,101336,54039,47297,24763,12096,12667
532,3,134139000,1,301414,3,86888936,01/10/2022,26.3,405952,215818,190134,89205,43880,45325
533,2,57687000,2,99302,2,37397248,01/10/2022,26,212540,111746,100794,51580,25268,26312
534,2,58772000,1,132852,2,38068948,01/10/2022,25.8,180057,96347,83710,45301,22589,22712
535,2,69824000,1,206001,2,45179599,01/10/2022,19.6,443063,237967,205096,110147,54509,55638
536,1,23552000,3,26375,1,15282425,01/10/2022,24.6,33226,17650,15576,10241,5095,5146
537,1,9473000,3,24694,1,6132756,01/10/2022,26.2,15512,8193,7319,4859,2440,2419
538,2,40767000,2,57276,2,26441274,01/10/2022,24.2,64445,34215,30230,17692,8626,9066
539,2,35929000,3,51994,2,23301856,01/10/2022,26.7,48567,25769,22798,13570,6693,6877
540,1,22181000,3,23652,1,14393998,01/10/2022,13.9,42451,22342,20109,14824,7241,7583
541,1,17762000,3,27540,1,11517760,01/10/2022,25.7,41588,21739,19849,12522,6161,6361
543,1,22628000,3,47091,1,14661109,01/10/2022,25.8,55452,29697,25755,14940,7380,7560
544,1,1567000,3,20687,1,997863,01/10/2022,26.3,6076,3180,2896,1703,844,859
545,2,40377000,2,59840,2,26185210,01/10/2022,25.8,64692,34002,30690,19678,9778,9900
546,1,4224000,3,24212,1,2721388,01/10/2022,26.2,22760,12125,10635,6420,3229,3191
547,1,15119000,3,32508,1,9794842,01/10/2022,25.5,25608,13480,12128,7723,3870,3853
548,1,10564000,2,54680,1,6811920,01/10/2022,24.2,15733,8506,7227,4079,2054,2025
549,1,7300000,3,22912,1,4722088,01/10/2022,19.5,41785,22480,19305,10854,5445,5409
550,1,9143000,3,35858,1,5907092,01/10/2022,25.6,13225,6946,6279,3476,1669,1807
551,1,13984000,3,34456,1,9055144,01/10/2022,20.3,28655,15243,13412,8764,4302,4462
552,1,6080000,3,31889,1,3920111,01/10/2022,24.3,17727,9423,8304,4199,2068,2131
553,1,11916000,2,88668,1,7656732,01/10/2022,26.2,8969,4883,4086,2821,1444,1377
554,1,11567000,3,22239,1,7496311,01/10/2022,26.7,16758,8967,7791,4993,2542,2451
555,2,32948000,3,43247,2,21372953,01/10/2022,25.1,47035,25085,21950,12872,6289,6583
556,1,18823000,3,27894,1,12207056,01/10/2022,25.8,55720,29557,26163,14521,7123,7398
557,1,18704000,3,26440,1,12131160,01/10/2022,24.4,46909,24866,22043,15156,7483,7673
558,1,11755000,3,28714,1,7612036,01/10/2022,24.4,33986,17827,16159,9043,4421,4622
559,1,13796000,3,26496,1,8940904,01/10/2022,19.5,34847,18666,16181,8943,4380,4563
560,1,13528000,3,33940,1,8759260,01/10/2022,26.1,14304,7545,6759,4455,2182,2273
561,1,8198000,3,24876,1,5303824,01/10/2022,26.2,20797,10995,9802,4991,2418,2573
562,1,15773000,3,22446,1,10230004,01/10/2022,26.2,30232,15727,14505,8913,4281,4632
563,1,21814000,2,62545,1,14116555,01/10/2022,25.6,20165,10621,9544,5395,2701,2694
564,1,2320000,3,23393,1,1484607,01/10/2022,25.8,20380,10692,9688,6259,3127,3132
565,1,10767000,3,26237,1,6972313,01/10/2022,14.1,21640,11976,9664,7433,3885,3548
566,1,19844000,3,32080,1,12866520,01/10/2022,16.6,33402,17876,15526,9753,4761,4992
567,1,19333000,3,41395,1,12525055,01/10/2022,24.3,26236,13620,12616,8067,3962,4105
568,1,3686000,3,20594,1,2375306,01/10/2022,25.5,4405,2358,2047,1451,735,716
569,1,3418000,3,22174,1,2199526,01/10/2022,25.7,13716,7109,6607,3981,1920,2061
570,1,10957000,3,25343,1,7096707,01/10/2022,26.1,5653,2987,2666,1709,826,883
571,1,10199000,3,34019,1,6595331,01/10/2022,25.9,21318,11472,9846,5688,2873,2815
572,1,9889000,3,22068,1,6405782,01/10/2022,26.1,14582,7621,6961,4539,2262,2277
573,1,1591000,3,27321,1,1006829,01/10/2022,25.7,6219,3311,2908,1883,941,942
574,1,9007000,3,29467,1,5825083,01/10/2022,26.1,31856,17018,14838,8563,4318,4245
575,1,16402000,3,22601,1,10638699,01/10/2022,19.5,35893,18883,17010,11399,5600,5799
576,1,15137000,3,29420,1,9809630,01/10/2022,25.9,19272,10328,8944,5163,2534,2629
577,1,15367000,3,27832,1,9960718,01/10/2022,14.2,16364,8711,7653,5250,2654,2596
578,1,10039000,3,25183,1,6500167,01/10/2022,26.3,2820,1449,1371,720,341,379
579,1,1995000,3,19974,1,1276776,01/10/2022,27,4654,2510,2144,1296,630,666
580,1,1394000,3,20553,1,885547,01/10/2022,14.2,21585,11243,10342,6456,3197,3259
581,1,1324000,3,21897,1,838703,01/10/2022,26.1,6888,3543,3345,1840,922,918
582,1,1771000,3,21794,1,1129356,01/10/2022,26,21391,11404,9987,5619,2742,2877
583,1,1702000,3,20725,1,1085575,01/10/2022,26.2,9668,5030,4638,2384,1141,1243
584,1,17043000,3,28190,1,11049760,01/10/2022,26.1,13995,7311,6684,4212,2070,2142
585,1,4397000,3,21198,1,2836852,01/10/2022,25.8,6838,3583,3255,1791,891,900
586,1,1710000,3,20725,1,1090775,01/10/2022,26,5681,3058,2623,1606,823,783
587,1,7401000,3,25005,1,4785645,01/10/2022,14.2,13966,7679,6287,3739,1859,1880
588,1,12893000,3,18191,1,8362259,01/10/2022,26.3,28076,14773,13303,7550,3752,3798
589,1,5845000,3,25005,1,3774245,01/10/2022,12,34039,18008,16031,8858,4334,4524
590,1,2010000,3,18648,1,1287852,01/10/2022,19.5,15807,8231,7576,5949,2955,2994
591,1,1099000,3,12805,1,701545,01/10/2022,25.8,10581,5508,5073,2907,1418,1489
592,1,3332000,3,23600,1,2142200,01/10/2022,17.5,9554,4935,4619,2707,1302,1405
593,1,13030000,3,51064,1,8418436,01/10/2022,24.4,9988,5342,4646,2237,1127,1110
594,1,2057000,3,12727,1,1324323,01/10/2022,26.1,7578,3984,3594,2088,1031,1057
595,1,2462000,3,22241,1,1578059,01/10/2022,18.6,8005,4106,3899,2599,1296,1303
596,1,3317000,3,20522,1,2135528,01/10/2022,26.3,24085,12288,11797,7909,3780,4129
597,1,4429000,3,21033,1,2857817,01/10/2022,26,7455,4054,3401,2223,1145,1078
598,1,1002000,3,7223,1,644077,01/10/2022,25.7,17919,9538,8381,4548,2298,2250
599,1,4521000,3,24262,1,2914388,01/10/2022,25.8,15305,8066,7239,4706,2332,2374
600,3,146497000,1,233177,3,94989873,01/10/2022,27.4,921771,479309,442462,222551,109790,112761
601,1,14078000,3,20720,1,9129980,01/10/2022,24.1,26081,13338,12743,7626,3791,3835
602,2,29779000,3,29817,2,19326533,01/10/2022,27.9,56494,29131,27363,17460,8617,8843
603,1,16872000,3,23214,1,10943586,01/10/2022,26.2,52593,26982,25611,16883,8307,8576
604,1,6085000,3,29612,1,3925638,01/10/2022,27.3,41965,21110,20855,11192,5453,5739
605,1,9009000,3,27448,1,5828402,01/10/2022,27.3,26175,13553,12622,8885,4301,4584
606,1,12391000,3,31559,1,8022591,01/10/2022,25.7,35183,17868,17315,10650,5230,5420
607,1,10446000,3,29810,1,6760090,01/10/2022,24.5,56409,28489,27920,16919,8292,8627
608,1,10031000,3,12954,1,6507196,01/10/2022,24.3,139753,70456,69297,45077,22298,22779
609,1,7443000,3,22050,1,4815900,01/10/2022,26.9,17841,9042,8799,5372,2677,2695
610,1,7030000,3,22108,1,4547392,01/10/2022,24.3,28461,14574,13887,9148,4533,4615
611,2,35751000,2,59188,2,23178962,01/10/2022,17.4,143281,73905,69376,47529,23519,24010
612,2,40771000,2,98900,2,26402250,01/10/2022,14.6,138444,72335,66109,38201,18773,19428
613,1,11715000,3,23018,1,7591732,01/10/2022,17.7,22295,11690,10605,8176,4115,4061
614,1,12526000,3,44101,1,8097799,01/10/2022,16.2,25068,12776,12292,8673,4237,4436
615,1,3093000,3,27201,1,1983249,01/10/2022,18,15291,7886,7405,5051,2477,2574
616,1,5448000,3,21170,1,3520030,01/10/2022,16.5,38193,19467,18726,13775,6896,6879
617,1,9929000,3,27702,1,6426148,01/10/2022,18.4,46132,23831,22301,13972,6871,7101
618,1,1892000,3,20482,1,1209318,01/10/2022,21.8,13641,7027,6614,4307,2133,2174
1,2,91205000,1,169289,2,59113961,01/09/2022,20.8,863893,444725,419168,260350,128225,132125
2,1,15523000,3,21443,1,10068507,01/09/2022,21.6,31963,16433,15530,11390,5609,5781
3,1,9589000,3,22188,1,6210662,01/09/2022,19.2,63805,32406,31399,23397,11652,11745
4,1,8749000,3,22041,1,5664809,01/09/2022,21.6,21049,10874,10175,7097,3529,3568
5,1,4272000,3,27167,1,2749633,01/09/2022,18.7,32035,16367,15668,10989,5374,5615
6,3,187904000,1,217375,3,121920225,01/09/2022,34.4,854186,425977,428209,227917,112151,115766
7,3,391284000,1,465582,3,253869018,01/09/2022,24.1,1810645,899293,911352,503963,246971,256992
8,2,84143000,2,83907,2,54609043,01/09/2022,23.4,330652,167339,163313,86895,42903,43992
9,2,33089000,3,27477,2,21480373,01/09/2022,25.9,81059,40420,40639,23492,11470,12022
10,2,32956000,3,51202,2,21370198,01/09/2022,22.8,100660,49935,50725,28067,13772,14295
11,1,17342000,3,22701,1,11249599,01/09/2022,32.1,19081,9476,9605,5934,2909,3025
12,2,65670000,1,114642,2,42570858,01/09/2022,30.5,250141,126245,123896,65670,32312,33358
13,2,49339000,2,74751,2,31995599,01/09/2022,26.2,136285,66083,70202,42780,21001,21779
14,2,65469000,2,94424,2,42460426,01/09/2022,29.2,202694,98608,104086,64935,31858,33077
15,1,19938000,3,28879,1,12930821,01/09/2022,27.6,43805,22160,21645,13050,6507,6543
16,1,21885000,2,63637,1,14161613,01/09/2022,29.7,16311,8010,8301,4984,2435,2549
17,1,7719000,3,22813,1,4994537,01/09/2022,31.8,14357,6822,7535,3854,1925,1929
18,1,2854000,3,18794,1,1836306,01/09/2022,24.7,13596,6842,6754,4196,2086,2110
19,1,6564000,3,19451,1,4247149,01/09/2022,26.1,13596,6842,6754,4196,2086,2110
20,1,2941000,3,28646,1,1883004,01/09/2022,26.9,7185,3509,3676,2099,1015,1084
21,2,39172000,2,67340,2,25394460,01/09/2022,26.9,191238,97313,93925,52600,25862,26738
22,2,38809000,2,62465,2,25163385,01/09/2022,28.6,249623,130524,119099,66498,32635,33863
23,1,24768000,3,24923,1,16074277,01/09/2022,28.9,31375,16375,15000,10682,5317,5365
24,1,16854000,3,27051,1,10928049,01/09/2022,28.1,35799,18291,17508,11962,5883,6079
25,1,11060000,3,21742,1,7167258,01/09/2022,29.2,15949,8217,7732,4538,2234,2304
26,2,73939000,2,86548,2,47973802,01/09/2022,27.1,217550,113613,103937,65123,32048,33075
27,2,44926000,3,46548,2,29155352,01/09/2022,17.8,183509,96930,86579,60413,30246,30167
28,2,47591000,2,71822,2,30862328,01/09/2022,20.4,113479,60064,53415,36594,18199,18395
29,2,96745000,2,92842,2,62791408,01/09/2022,25,578830,303756,275074,166456,82025,84431
30,2,34170000,3,45325,2,22165175,01/09/2022,27,51797,27093,24704,17614,8812,8802
31,2,53518000,2,103211,2,34683489,01/09/2022,26,38087,20017,18070,11916,5833,6083
32,1,12543000,3,22227,1,8130723,01/09/2022,29.4,32109,16780,15329,10495,5074,5421
33,1,22499000,3,22845,1,14601505,01/09/2022,24.5,21727,11415,10312,7786,3890,3896
34,1,14862000,3,28208,1,9632092,01/09/2022,26,49201,25651,23550,16539,8102,8437
35,1,20576000,3,33374,1,13341026,01/09/2022,25.5,37546,19668,17878,11791,5836,5955
36,1,22106000,2,76329,1,14292571,01/09/2022,19.8,47688,25247,22441,17870,8920,8950
37,1,4503000,3,23477,1,2903473,01/09/2022,28,55931,28786,27145,18430,9082,9348
38,1,11260000,3,22533,1,7296467,01/09/2022,24.2,29018,15064,13954,10291,5191,5100
39,1,9112000,3,33590,1,5889210,01/09/2022,25.1,18219,9592,8627,5806,2838,2968
40,1,12362000,3,18435,1,8016865,01/09/2022,27,15244,8058,7186,4848,2429,2419
41,1,5203000,3,22538,1,3359412,01/09/2022,28.8,25366,13345,12021,7752,3823,3929
42,1,16044000,3,23632,1,10404968,01/09/2022,26.3,19271,9996,9275,6517,3095,3422
43,1,4378000,3,20951,1,2824749,01/09/2022,27.7,7662,4073,3589,2321,1153,1168
45,3,276342000,1,235748,3,179386552,01/09/2022,24.1,1501551,750157,751394,459910,225614,234296
46,3,102412000,1,169676,3,66398124,01/09/2022,22.1,925762,474776,450986,250961,123448,127513
47,1,28678000,3,49906,1,18590794,01/09/2022,25.4,128548,65838,62710,37721,18411,19310
48,1,22804000,3,27978,1,14794622,01/09/2022,18.9,135586,69677,65909,41627,20458,21169
49,2,29773000,2,54050,2,19298400,01/09/2022,21.2,113843,59214,54629,34117,16974,17143
50,1,5366000,3,22364,1,3465536,01/09/2022,25.9,23140,11693,11447,7155,3499,3656
51,1,8336000,3,24716,1,5393684,01/09/2022,22.9,35087,17902,17185,11563,5663,5900
52,1,12628000,3,27780,1,8180420,01/09/2022,23.5,42019,21548,20471,12599,6234,6365
53,1,9323000,3,24709,1,6035241,01/09/2022,28.4,22066,11231,10835,6719,3420,3299
54,1,8218000,3,22288,1,5319412,01/09/2022,15.5,17410,9121,8289,6393,3204,3189
55,1,1903000,3,22745,1,1214205,01/09/2022,22.5,22568,11549,11019,7200,3540,3660
56,1,6248000,3,23573,1,4037627,01/09/2022,17.8,15054,7516,7538,5557,2768,2789
57,1,3876000,2,70707,1,2448693,01/09/2022,21.9,8253,4210,4043,2801,1419,1382
58,1,4731000,3,22486,1,3052664,01/09/2022,16.9,7834,4065,3769,2439,1200,1239
59,1,1800000,3,21237,1,1148763,01/09/2022,13.9,14755,7617,7138,4907,2427,2480
60,1,11805000,3,29761,1,7643489,01/09/2022,21.8,62038,31762,30276,19262,9511,9751
61,2,91049000,1,122533,2,59059317,01/09/2022,16.9,690193,353744,336449,203574,99881,103693
62,3,130138000,1,172418,3,84417282,01/09/2022,20.1,864431,434753,429678,267728,131619,136109
63,2,39691000,2,73692,2,25725458,01/09/2022,27.1,237169,119538,117631,71348,35023,36325
64,2,46458000,2,66125,2,30131575,01/09/2022,31.6,173959,86825,87134,55826,27459,28367
65,1,9884000,3,24838,1,6399762,01/09/2022,26.6,39058,19755,19303,11201,5479,5722
66,3,103157000,1,156446,3,66895604,01/09/2022,24.8,59762,30506,29256,20025,9931,10094
67,1,13566000,3,31337,1,8786563,01/09/2022,25.5,49490,25496,23994,16916,8460,8456
68,1,26637000,3,49888,1,17264162,01/09/2022,26.1,160225,79799,80426,53549,26489,27060
69,1,14448000,3,15882,1,9375318,01/09/2022,21.1,114010,56192,57818,38156,18905,19251
70,1,23662000,3,34641,1,15345659,01/09/2022,25.5,75242,37695,37547,23792,11778,12014
71,1,11186000,3,24004,1,7246896,01/09/2022,26.3,59196,29915,29281,18125,8949,9176
72,1,14409000,3,20606,1,9345244,01/09/2022,25.5,32704,16713,15991,11320,5572,5748
73,1,6430000,3,25985,1,4153515,01/09/2022,26.6,23413,11884,11529,7157,3552,3605
74,1,9524000,3,24028,1,6166572,01/09/2022,26.8,38992,19602,19390,13022,6299,6723
75,1,1897000,3,24019,1,1209031,01/09/2022,26.1,27314,13703,13611,9005,4397,4608
76,2,49844000,2,70781,2,32327819,01/09/2022,24.3,146965,75962,71003,46271,22786,23485
77,1,25181000,3,43877,1,16323773,01/09/2022,30,88337,44762,43575,34686,17254,17432
78,2,36583000,2,66540,2,23712410,01/09/2022,29.4,159853,80569,79284,57402,28064,29338
79,1,2664000,3,22408,1,1709192,01/09/2022,26,9746,4912,4834,3336,1602,1734
80,1,2141000,3,18092,1,1373558,01/09/2022,29.1,15368,7632,7736,5699,2779,2920
81,1,1215000,3,9284,1,780466,01/09/2022,27,147496,76348,71148,49524,24280,25244
82,1,982000,3,17671,1,620629,01/09/2022,27.3,14892,7420,7472,5365,2615,2750
83,1,7785000,3,19035,1,5041215,01/09/2022,25,34798,17459,17339,10865,5211,5654
84,2,37638000,1,172225,2,24292475,01/09/2022,19,432205,227255,204950,86717,42372,44345
85,2,40766000,1,174885,2,26323015,01/09/2022,19,759003,398068,360935,168014,83097,84917
86,2,91672000,1,309205,2,59277595,01/09/2022,20,1173351,609477,563874,261635,129105,132530
87,1,26605000,2,60712,1,17232538,01/09/2022,1.5,414470,219003,195467,75588,37198,38390
88,1,17261000,2,56496,1,11163154,01/09/2022,17,186693,97615,89078,46165,22603,23562
89,3,152335000,1,351774,3,98665976,01/09/2022,19,1835486,947835,887651,451632,222341,229291
90,2,47180000,1,116128,2,30550872,01/09/2022,19,614447,325337,289110,113945,55951,57994
91,1,26343000,2,83860,1,17039090,01/09/2022,18.8,434153,232032,202121,62030,30612,31418
92,2,51019000,1,121443,2,33040907,01/09/2022,18,323771,167274,156497,83659,40990,42669
93,2,44356000,2,88024,2,28743376,01/09/2022,17.2,404695,212343,192352,85496,42058,43438
94,1,26143000,1,144519,1,16848431,01/09/2022,19,443704,233586,210118,95713,47173,48540
95,2,60495000,1,237494,2,39084256,01/09/2022,19,545884,284933,260951,101794,50260,51534
96,1,15244000,2,56879,1,9851721,01/09/2022,17.9,429481,220393,209088,105785,52018,53767
97,1,8380000,3,45139,1,5401861,01/09/2022,14.7,246428,128767,117661,58169,28791,29378
98,1,11489000,3,31615,1,7436235,01/09/2022,14.7,599935,314284,285651,130174,64060,66114
99,3,114966000,1,134342,3,74593558,01/09/2022,20.9,616068,317266,298802,191866,94056,97810
100,2,65250000,2,87058,2,42325442,01/09/2022,19.7,301742,154079,147663,97495,48007,49488
101,1,8799000,3,20318,1,5699032,01/09/2022,23.7,96243,49040,47203,29383,14345,15038
102,1,15403000,3,28625,1,9983325,01/09/2022,22.5,30063,15334,14729,10450,5151,5299
103,1,1555000,3,50655,1,960095,01/09/2022,28.7,3222,1654,1568,1247,637,610
104,1,11826000,3,47878,1,7639022,01/09/2022,19.3,17967,9205,8762,6003,2945,3058
105,1,1843000,3,21273,1,1176677,01/09/2022,18,11943,6311,5632,3854,1993,1861
106,1,1818000,2,92961,1,1088739,01/09/2022,22.2,12850,6538,6312,4678,2267,2411
107,2,36389000,2,98117,2,23554733,01/09/2022,14.9,26678,13733,12945,10032,4897,5135
108,3,157001000,1,221265,3,101829385,01/09/2022,15.8,223876,119352,104524,50306,24928,25378
109,2,54973000,1,171657,2,35560793,01/09/2022,16.4,515353,266081,249272,126007,61695,64312
110,2,92431000,1,310464,2,59769686,01/09/2022,17.6,776220,402522,373698,193769,95439,98330
111,2,55846000,2,91473,2,36208427,01/09/2022,16.5,84298,43745,40553,23019,11356,11663
112,2,43377000,2,57497,2,28137553,01/09/2022,18,30929,15848,15081,8319,4034,4285
113,1,28853000,1,125383,1,18629067,01/09/2022,18.2,293245,152241,141004,70657,34731,35926
114,2,52968000,1,206970,2,34222230,01/09/2022,16.5,658907,338453,320454,150053,73914,76139
115,1,24460000,3,24634,1,15874366,01/09/2022,16.4,117995,60165,57830,29983,14851,15132
116,3,153203000,1,349291,3,99232659,01/09/2022,15.5,1643623,845932,797691,437489,216020,221469
117,2,68996000,1,146752,2,44700648,01/09/2022,20,368585,190133,178452,107535,52900,54635
118,2,40320000,2,58377,2,26149623,01/09/2022,9.9,174704,91497,83207,54449,28355,26094
119,1,18637000,3,44542,1,12069508,01/09/2022,7.5,2931,1520,1411,975,512,463
120,2,50555000,2,100781,2,32759969,01/09/2022,9.8,35491,18986,16505,7987,3993,3994
121,2,58624000,1,150865,2,37954735,01/09/2022,16.7,703215,359601,343614,230612,113552,117060
122,2,56952000,1,177429,2,36841371,01/09/2022,17.8,18226,9300,8926,5308,2603,2705
123,2,47030000,2,74154,2,30495346,01/09/2022,18.1,1072676,556998,515678,265425,131078,134347
124,1,20190000,3,19249,1,13104251,01/09/2022,20.6,14038,7254,6784,3763,1910,1853
125,2,64415000,2,81655,2,41788095,01/09/2022,9.9,174704,91497,83207,54449,28355,26094
126,2,47839000,3,29321,2,31066029,01/09/2022,16,7077,3593,3484,1748,893,855
127,2,33196000,2,52732,2,21524668,01/09/2022,16.8,53362,27304,26058,15169,7515,7654
128,1,15628000,3,22003,1,10136197,01/09/2022,6.3,24612,12254,12358,7339,3541,3798
129,2,44517000,1,157269,2,28778781,01/09/2022,17.3,10873,5623,5250,3757,1878,1879
130,2,52560000,3,50101,2,34113899,01/09/2022,14.5,23219,12339,10880,6425,3186,3239
131,1,23887000,3,29953,1,15496597,01/09/2022,16.8,12671,6512,6159,3454,1710,1744
132,1,18365000,3,25193,1,11912057,01/09/2022,15.4,30967,16277,14690,10756,5327,5429
133,2,36020000,2,55269,2,23357731,01/09/2022,17,323545,166328,157217,93932,46757,47175
134,1,6127000,3,19147,1,3963403,01/09/2022,20.9,19326,10155,9171,6252,3129,3123
135,1,18894000,3,23006,1,12258094,01/09/2022,9.9,33716,17686,16030,9317,4624,4693
136,1,11947000,3,48637,1,7716913,01/09/2022,16.7,40279,20716,19563,10282,5078,5204
137,1,3731000,3,15090,1,2410060,01/09/2022,17.1,29068,14916,14152,8580,4220,4360
138,1,25757000,3,43547,1,16698503,01/09/2022,18.3,12752,6694,6058,3471,1768,1703
139,1,4058000,3,41652,1,2596048,01/09/2022,15.7,33166,16973,16193,9497,4707,4790
140,1,5960000,3,15047,1,3858953,01/09/2022,16.4,52828,27143,25685,16500,8128,8372
141,2,29097000,3,25798,2,18887252,01/09/2022,16,32738,16941,15797,9059,4431,4628
142,1,8461000,3,24853,1,5474797,01/09/2022,17.4,30203,15792,14411,7568,3777,3791
143,1,28450000,3,36523,1,18455977,01/09/2022,16.4,11760,6069,5691,3432,1700,1732
144,1,9400000,3,21152,1,6088848,01/09/2022,18.6,72525,37076,35449,22128,10944,11184
145,1,8762000,3,20348,1,5674952,01/09/2022,7.6,18580,9729,8851,5724,2801,2923
146,1,17643000,3,30175,1,11437775,01/09/2022,17.8,24575,12798,11777,7126,3453,3673
147,1,1357000,3,14051,1,867999,01/09/2022,18.2,44731,22925,21806,13335,6514,6821
148,1,7386000,2,54324,1,4746576,01/09/2022,16,658907,338453,320454,150053,73914,76139
149,1,13325000,3,21002,1,8640248,01/09/2022,18,10336,5387,4949,3449,1664,1785
150,1,10422000,3,14746,1,6759554,01/09/2022,14.3,4656,2421,2235,1533,751,782
151,1,6453000,3,23043,1,4171407,01/09/2022,17,9598,5002,4596,2910,1467,1443
152,1,9788000,3,21308,1,6340892,01/09/2022,16.4,15171,7853,7318,4470,2251,2219
153,1,5535000,3,22837,1,3574913,01/09/2022,17.1,10792,5577,5215,3492,1713,1779
154,1,1989000,3,4006,1,1288844,01/09/2022,16.4,37442,19141,18301,12089,5963,6126
155,1,2793000,3,18420,1,1797030,01/09/2022,9.9,17736,9182,8554,5577,2775,2802
156,1,7597000,3,13220,1,4924830,01/09/2022,17.8,386290,199249,187041,112223,55337,56886
157,1,8553000,3,29986,1,5529464,01/09/2022,17.8,9925,5218,4707,2833,1403,1430
158,1,8038000,3,24365,1,5200335,01/09/2022,20.7,6944,3666,3278,2341,1149,1192
159,1,6990000,3,28375,1,4515125,01/09/2022,15.6,88734,45471,43263,28316,14166,14150
160,1,7700000,3,22665,1,4982335,01/09/2022,10,6449,3346,3103,1687,833,854
161,1,6199000,3,22368,1,4006982,01/09/2022,15.3,10735,5576,5159,3010,1518,1492
162,1,2566000,3,21579,1,1646321,01/09/2022,10,10810,5614,5196,2941,1451,1490
163,1,1213000,3,956,1,787494,01/09/2022,26.8,13038,6614,6424,4157,2015,2142
165,3,162598000,1,215580,3,105473120,01/09/2022,21.7,1579803,804212,775591,594938,292494,302444
166,2,69438000,2,67656,2,45067044,01/09/2022,18.4,378143,194849,183294,128863,62806,66057
167,2,66171000,2,68963,2,42942187,01/09/2022,21.4,452090,230346,221744,162764,80177,82587
168,1,19450000,3,33752,1,12608748,01/09/2022,20.2,69371,35473,33898,25304,12303,13001
169,1,27995000,3,48278,1,18148472,01/09/2022,20.3,79772,40908,38864,30907,15312,15595
170,1,21117000,3,37034,1,13689016,01/09/2022,19.9,56597,29703,26894,19146,9514,9632
171,1,21258000,3,34257,1,13783443,01/09/2022,19.5,72663,38036,34627,27395,13712,13683
172,2,41992000,2,75118,2,27219682,01/09/2022,20.4,160682,83178,77504,52342,25860,26482
173,1,26848000,3,35850,1,17415350,01/09/2022,19.8,83352,42766,40586,32937,16375,16562
174,2,29895000,3,32496,2,19399254,01/09/2022,17.8,67101,35567,31534,27008,13393,13615
175,1,15585000,3,28917,1,10101333,01/09/2022,19.1,43249,22352,20897,17065,8284,8781
176,1,23420000,3,39865,1,15183135,01/09/2022,18.6,51894,27702,24192,20579,10113,10466
177,1,21949000,3,42628,1,14224222,01/09/2022,20.3,70068,36526,33542,21044,10402,10642
178,1,17432000,3,19134,1,11311666,01/09/2022,20.5,52156,27081,25075,17108,8394,8714
179,1,3724000,3,18780,1,2401820,01/09/2022,20.5,41910,21741,20169,12631,6146,6485
180,1,21337000,3,41188,1,13827862,01/09/2022,18.7,43998,23109,20889,17575,8775,8800
181,1,4468000,3,18435,1,2885765,01/09/2022,22.4,24757,12827,11930,9816,4898,4918
182,1,3471000,3,18372,1,2237778,01/09/2022,19.2,21756,11234,10522,8659,4317,4342
183,1,7597000,3,15100,1,4922950,01/09/2022,18.7,28109,14419,13690,10548,5187,5361
184,1,5233000,3,25446,1,3376004,01/09/2022,22,15305,7996,7309,5899,2872,3027
185,1,25041000,2,53688,1,16222962,01/09/2022,18.3,72452,38019,34433,23628,11618,12010
186,1,15992000,3,24707,1,10370093,01/09/2022,20,35401,18444,16957,12235,5945,6290
187,1,22316000,3,42838,1,14462562,01/09/2022,19,27593,14289,13304,10803,5260,5543
188,1,16798000,3,23089,1,10895611,01/09/2022,20.8,31264,16171,15093,9806,4840,4966
189,1,16842000,3,41594,1,10905706,01/09/2022,16.3,24228,12861,11367,9383,4674,4709
190,1,17204000,3,24743,1,11157857,01/09/2022,15.4,32831,17049,15782,13856,6706,7150
191,1,2579000,3,23385,1,1652965,01/09/2022,20.8,16092,8507,7585,6837,3451,3386
192,1,6713000,3,23379,1,4340071,01/09/2022,18.4,8011,4268,3743,3134,1562,1572
193,1,13339000,3,20029,1,8650321,01/09/2022,21.5,29002,14796,14206,11206,5550,5656
194,1,2499000,3,19770,1,1604580,01/09/2022,16.1,7946,4172,3774,3293,1607,1686
195,1,10254000,3,12118,1,6652982,01/09/2022,19.9,28260,14728,13532,11002,5473,5529
196,1,5470000,3,6425,1,3549075,01/09/2022,19.3,25845,13471,12374,9370,4627,4743
197,3,123429000,1,195730,3,80033120,01/09/2022,28.3,658609,345979,312630,183298,90145,93153
198,2,52200000,3,44539,2,33885461,01/09/2022,23.4,225728,119129,106599,71494,35347,36147
199,2,29643000,3,36773,2,19231177,01/09/2022,31.2,70760,36613,34147,21788,10705,11083
200,2,38223000,2,60073,2,24784877,01/09/2022,25.1,132854,69610,63244,41183,20301,20882
201,1,16351000,2,58199,1,10569951,01/09/2022,19.9,50399,26542,23857,14000,6918,7082
202,1,3070000,3,19678,1,1975822,01/09/2022,22,27944,14419,13525,9490,4664,4826
203,1,5126000,3,20446,1,3311454,01/09/2022,20.9,22534,11802,10732,7926,3939,3987
204,1,12623000,3,22816,1,8182134,01/09/2022,27.4,25148,13436,11712,8928,4476,4452
205,1,22555000,3,22628,1,14638122,01/09/2022,21.9,33783,18241,15542,12201,6089,6112
206,2,30267000,3,21183,2,19652367,01/09/2022,27.1,25850,13268,12582,8390,4048,4342
208,2,30688000,3,37914,2,19909286,01/09/2022,19.1,27607,14605,13002,9883,5002,4881
209,1,7936000,3,20690,1,5137710,01/09/2022,26.5,13866,7187,6679,4383,2099,2284
210,1,7014000,3,5477,1,4553623,01/09/2022,26.8,23363,12127,11236,7776,3818,3958
211,1,15549000,3,22278,1,10084572,01/09/2022,24.7,18224,9500,8724,7072,3514,3558
212,1,12532000,3,26200,1,8119600,01/09/2022,27.9,16447,8464,7983,4843,2381,2462
213,1,5370000,3,14021,1,3476479,01/09/2022,23.1,17550,9283,8267,5700,2861,2839
214,2,61335000,1,143771,2,39723979,01/09/2022,17,297848,156299,141549,74787,37046,37741
215,1,26362000,3,35374,1,17099926,01/09/2022,19.6,29390,15521,13869,7939,3942,3997
216,2,30862000,2,67431,2,19992869,01/09/2022,19.2,37608,20094,17514,11115,5490,5625
217,2,36702000,2,71956,2,23784344,01/09/2022,17.1,106163,56161,50002,30752,15034,15718
218,1,13083000,3,18306,1,8485644,01/09/2022,15.8,11149,5894,5255,2996,1479,1517
219,2,35518000,2,55909,2,23030791,01/09/2022,15,60265,30945,29320,18808,9224,9584
220,1,18802000,3,26308,1,12194992,01/09/2022,19.3,17718,9411,8307,4913,2492,2421
221,1,16107000,3,28554,1,10440996,01/09/2022,18.2,36618,19077,17541,10530,5273,5257
222,1,12684000,3,25551,1,8219049,01/09/2022,18.4,9853,5224,4629,2757,1390,1367
223,1,2651000,3,19489,1,1703661,01/09/2022,17.8,27713,14561,13152,7736,3885,3851
224,1,6863000,3,22279,1,4438671,01/09/2022,18.7,32276,17014,15262,9457,4578,4879
225,1,7778000,3,22823,1,5032877,01/09/2022,18.4,14689,7582,7107,4123,2033,2090
226,2,38833000,3,46489,2,25194961,01/09/2022,28.2,44311,23331,20980,13756,6771,6985
227,1,4209000,3,23477,1,2712373,01/09/2022,22.2,14732,7791,6941,4911,2433,2478
228,1,11033000,3,25175,1,7146275,01/09/2022,17,20530,10890,9640,6356,3180,3176
229,1,11781000,3,22745,1,7634905,01/09/2022,26.1,16368,8558,7810,4728,2323,2405
230,1,7691000,3,24709,1,4974441,01/09/2022,14.9,6213,3216,2997,1786,871,915
231,1,9785000,3,22331,1,6337919,01/09/2022,15,28792,15288,13504,8327,4111,4216
232,1,1066000,3,0,1,692900,01/09/2022,18.8,29472,15519,13953,9890,4934,4956
233,1,4934000,3,6731,1,3200369,01/09/2022,18.6,8657,4501,4156,2464,1200,1264
234,2,66008000,1,105084,2,42800116,01/09/2022,28,224166,112147,112019,65088,31954,33134
235,1,27498000,2,68785,1,17804915,01/09/2022,20.3,111569,57370,54199,36412,17892,18520
236,1,24460000,3,33735,1,15865265,01/09/2022,21,38780,20122,18658,13025,6461,6564
237,3,143990000,1,328862,3,93264638,01/09/2022,20.5,1385621,718628,666993,333198,164217,168981
238,2,99914000,1,225325,2,64718775,01/09/2022,20.8,1257547,645398,612149,321993,158559,163434
239,1,19759000,3,29874,1,12813476,01/09/2022,22.9,37871,19554,18317,11359,5732,5627
240,2,82964000,1,203309,2,53723291,01/09/2022,23.7,650123,329365,320758,200033,98558,101475
241,2,37612000,2,69316,2,24378484,01/09/2022,22.4,111975,57735,54240,31481,15460,16021
242,1,13134000,3,24817,1,8512283,01/09/2022,21,98842,50427,48415,30938,15263,15675
243,2,62297000,1,155331,2,40337719,01/09/2022,21.6,44103,22420,21683,15768,7755,8013
244,1,10339000,3,19957,1,6700393,01/09/2022,19.7,53539,27205,26334,18000,8916,9084
245,1,10675000,3,26326,1,6912424,01/09/2022,28.1,18787,9476,9311,6502,3270,3232
246,1,15036000,3,35435,1,9737965,01/09/2022,21,59648,30609,29039,19344,9536,9808
247,2,50643000,2,94209,2,32823741,01/09/2022,23,30471,15635,14836,9610,4654,4956
248,1,4364000,3,18127,1,2818473,01/09/2022,22,20286,10307,9979,6804,3413,3391
249,1,4172000,3,21661,1,2690139,01/09/2022,22.8,20345,10131,10214,6733,3300,3433
250,1,18555000,3,25685,1,12035065,01/09/2022,22.4,31115,15891,15224,10525,5240,5285
251,1,12646000,3,40588,1,8179312,01/09/2022,22,16550,8456,8094,5252,2552,2700
252,1,15826000,3,19038,1,10267862,01/09/2022,22.5,24352,12627,11725,8092,4062,4030
253,1,18032000,3,39286,1,11681514,01/09/2022,20.2,94978,48709,46269,29794,14672,15122
254,1,22101000,3,24087,1,14341563,01/09/2022,26.1,52019,26739,25280,15725,7759,7966
255,1,3904000,3,26207,1,2511393,01/09/2022,21.5,24580,12765,11815,8215,4057,4158
256,1,12941000,3,18407,1,8393243,01/09/2022,24.3,28678,14679,13999,9074,4497,4577
257,1,3818000,3,22279,1,2459421,01/09/2022,16,22738,11719,11019,7000,3537,3463
258,1,10710000,3,22599,1,6938901,01/09/2022,22.4,28145,14670,13475,8863,4390,4473
259,1,8347000,3,20236,1,5405314,01/09/2022,22.4,19113,9852,9261,5504,2716,2788
260,1,2311000,3,22049,1,1480101,01/09/2022,19.7,25925,13382,12543,8585,4189,4396
261,1,1082000,3,23385,1,679915,01/09/2022,24.3,13033,6697,6336,4420,2181,2239
262,1,2845000,3,22212,1,1827038,01/09/2022,9.7,5955,3118,2837,1972,974,998
263,1,1407000,3,13707,1,900843,01/09/2022,22.4,8850,4524,4326,2773,1377,1396
264,1,2389000,3,20463,1,1532387,01/09/2022,16,9529,4943,4586,3018,1490,1528
265,1,8949000,3,22301,1,5794549,01/09/2022,19.7,14636,7533,7103,4910,2424,2486
266,1,16388000,3,38125,1,10614075,01/09/2022,22,40906,20800,20106,12864,6409,6455
267,1,6109000,3,19294,1,3951556,01/09/2022,22.4,8142,4289,3853,2686,1333,1353
268,1,2125000,3,22997,1,1358253,01/09/2022,15.7,7954,4060,3894,2570,1274,1296
269,1,9561000,3,24731,1,6189919,01/09/2022,22.4,17000,8527,8473,5215,2549,2666
270,1,3331000,3,23041,1,2142109,01/09/2022,19.5,14424,7439,6985,5399,2678,2721
271,1,2658000,3,22173,1,1705527,01/09/2022,22.4,16873,8725,8148,6022,3008,3014
272,1,3176000,3,18902,1,2045498,01/09/2022,22.4,5109,2618,2491,1631,805,826
273,1,2233000,3,22495,1,1428955,01/09/2022,22.3,13243,6795,6448,4043,1954,2089
274,1,2597000,3,22280,1,1665770,01/09/2022,19.7,14497,7627,6870,4260,2099,2161
275,1,2203000,3,20273,1,1411677,01/09/2022,21.9,16324,8373,7951,5562,2774,2788
276,1,5071000,3,22918,1,3273232,01/09/2022,27.9,9842,5047,4795,3323,1629,1694
277,1,2588000,3,21502,1,1660698,01/09/2022,19.7,27833,14525,13308,9097,4581,4516
278,1,4892000,3,6228,1,3173572,01/09/2022,25.2,33284,17172,16112,10804,5349,5455
279,1,2227000,3,22563,1,1424987,01/09/2022,24.4,14697,7601,7096,4740,2380,2360
280,1,3758000,3,20435,1,2422265,01/09/2022,20.2,18607,9363,9244,6403,3178,3225
284,2,98221000,1,126117,2,63717533,01/09/2022,18.9,743275,388114,355161,202467,99875,102592
285,2,37439000,2,92172,2,24243178,01/09/2022,20,154546,80401,74145,48513,24003,24510
286,2,63976000,2,87965,2,41496435,01/09/2022,19.8,299523,155411,144112,93845,46362,47483
287,2,42851000,2,74421,2,27778729,01/09/2022,29.8,83637,42325,41312,24783,12286,12497
288,2,33916000,2,72089,2,21973311,01/09/2022,29.3,102362,52461,49901,35162,17416,17746
289,1,16699000,3,34199,1,10820151,01/09/2022,21.3,55287,28877,26410,16959,8447,8512
290,1,20682000,3,39427,1,13403873,01/09/2022,22.5,87042,45232,41810,26414,12958,13456
291,2,34077000,2,58432,2,22091618,01/09/2022,12.3,86901,45620,41281,26262,13160,13102
292,1,19725000,3,24028,1,12797222,01/09/2022,19.7,30519,15931,14588,10809,5325,5484
293,2,30221000,3,32489,2,19611161,01/09/2022,18.2,60811,31893,28918,19713,9706,10007
294,1,3554000,3,12460,1,2297640,01/09/2022,17.3,61510,31765,29745,21000,10487,10513
295,1,21604000,2,54016,1,13988584,01/09/2022,20,70042,36241,33801,21818,10809,11009
296,1,4012000,3,13596,1,2594204,01/09/2022,20.8,24662,12965,11697,6937,3350,3587
297,1,5938000,3,14540,1,3845160,01/09/2022,17.3,15414,7999,7415,4635,2291,2344
298,1,22357000,3,18352,1,14513698,01/09/2022,18.4,71528,37497,34031,23278,11539,11739
299,1,2072000,3,17998,1,1328802,01/09/2022,19.7,15249,7932,7317,4894,2453,2441
300,1,26839000,3,23899,1,17421451,01/09/2022,18.5,39425,20578,18847,13203,6477,6726
301,1,3632000,3,17884,1,2342916,01/09/2022,20.8,17293,8766,8527,5650,2795,2855
302,1,11312000,3,19038,1,7333762,01/09/2022,12.3,16905,8772,8133,5514,2740,2774
303,1,3825000,3,23270,1,2462980,01/09/2022,18.2,18097,9360,8737,5881,2892,2989
304,1,11789000,3,23902,1,7638948,01/09/2022,20.4,32333,16690,15643,10314,5057,5257
305,1,16946000,3,23072,1,10991828,01/09/2022,19.6,49940,25545,24395,16071,7998,8073
306,1,15680000,3,20025,1,10171975,01/09/2022,19.8,1049,546,503,282,149,133
307,1,13699000,3,24708,1,8879642,01/09/2022,19.8,6853,3584,3269,2311,1149,1162
308,1,6959000,3,6025,1,4517325,01/09/2022,26.9,12262,6119,6143,4251,2104,2147
309,1,2581000,3,30198,1,1647452,01/09/2022,19.6,11086,5609,5477,3615,1780,1835
310,1,2552000,3,27565,1,1631235,01/09/2022,22.5,13821,7083,6738,3938,1966,1972
311,2,47897000,1,144704,2,30988346,01/09/2022,21.9,341029,180370,160659,82444,40670,41774
312,2,64459000,2,87277,2,41811073,01/09/2022,21.4,157336,82380,74956,43883,21497,22386
313,1,21587000,3,11445,1,14020105,01/09/2022,26.1,174629,91268,83361,46521,22880,23641
314,1,28976000,3,44784,1,18789616,01/09/2022,23.7,104461,54150,50311,30967,15315,15652
315,1,13977000,3,48817,1,9036233,01/09/2022,22.4,44353,23038,21315,13070,6400,6670
316,1,5492000,3,19563,1,3550237,01/09/2022,25.5,21375,11206,10169,5662,2753,2909
317,2,30213000,3,39896,2,19598554,01/09/2022,26.2,17777,9225,8552,4254,2086,2168
318,2,36545000,2,92528,2,23661722,01/09/2022,26.1,64084,32934,31150,19785,9668,10117
319,1,14809000,3,20650,1,9605200,01/09/2022,25.8,20434,10867,9567,5939,2970,2969
320,1,13498000,3,27623,1,8746077,01/09/2022,17.4,19085,9763,9322,6343,3119,3224
321,2,92404000,1,107642,2,59954958,01/09/2022,25.1,371387,192530,178857,106784,52432,54352
322,1,18018000,3,21195,1,11690505,01/09/2022,28.4,18023,9240,8783,5154,2503,2651
323,1,12412000,3,38513,1,8029287,01/09/2022,24,20322,10479,9843,6201,3025,3176
324,1,16832000,3,31793,1,10909007,01/09/2022,24,25477,13300,12177,8208,4059,4149
325,1,7564000,3,42399,1,4874201,01/09/2022,28.6,13620,7015,6605,4098,1994,2104
326,1,10536000,3,17591,1,6830809,01/09/2022,24,48170,25016,23154,15515,7657,7858
327,1,7511000,3,41979,1,4840171,01/09/2022,30.1,10593,5340,5253,3485,1705,1780
328,2,35437000,2,60640,2,22973410,01/09/2022,28.4,8730,4395,4335,2894,1447,1447
329,1,4212000,3,23614,1,2714186,01/09/2022,28.5,14678,7367,7311,4863,2405,2458
330,1,7252000,3,24887,1,4688913,01/09/2022,28.4,10935,5450,5485,3532,1706,1826
331,1,9399000,3,23522,1,6085828,01/09/2022,29.7,19976,10345,9631,6431,3120,3311
332,2,54854000,2,102577,2,35552523,01/09/2022,29,412199,209241,202958,82879,40585,42294
333,2,53883000,1,122190,2,34901760,01/09/2022,27.5,304052,152635,151417,84118,41457,42661
334,2,81301000,2,103833,2,52741817,01/09/2022,25.6,536436,267279,269157,158598,77797,80801
335,3,111162000,1,146936,3,72108364,01/09/2022,25.6,635862,320627,315235,153834,75737,78097
336,3,135696000,1,189822,3,88012578,01/09/2022,27.7,1142952,578172,564780,270109,132170,137939
338,1,15713000,3,32577,1,10180873,01/09/2022,25.6,75721,38037,37684,21903,10795,11108
339,1,17364000,3,35438,1,11251162,01/09/2022,28.6,70378,35870,34508,21367,10464,10903
340,2,40766000,3,27603,2,26470297,01/09/2022,16.7,308285,152976,155309,108145,53196,54949
342,2,38232000,3,50224,2,24800576,01/09/2022,24,234698,115478,119220,87040,43098,43942
343,1,11733000,3,19511,1,7606939,01/09/2022,25.6,28843,14318,14525,8529,4190,4339
344,1,11052000,3,23555,1,7160245,01/09/2022,25.9,33522,17126,16396,9330,4711,4619
345,1,15104000,3,40523,1,9777077,01/09/2022,26.5,54467,27606,26861,15858,7789,8069
346,1,14640000,3,20875,1,9495125,01/09/2022,29,13059,6525,6534,4137,2073,2064
347,1,1049000,3,4437,1,677413,01/09/2022,16.7,9934,4952,4982,3082,1558,1524
348,1,5240000,3,24794,1,3381206,01/09/2022,16.7,7844,4131,3713,2621,1355,1266
349,1,8341000,3,41846,1,5379804,01/09/2022,25.6,48069,23121,24948,16392,8040,8352
350,1,10463000,3,21167,1,6779783,01/09/2022,27.5,11583,5810,5773,3713,1872,1841
351,1,4089000,3,21066,1,2636784,01/09/2022,26.8,29903,15539,14364,9778,4798,4980
352,3,132153000,1,247455,3,85651995,01/09/2022,22.6,258913,138803,120110,68042,33683,34359
353,2,49467000,2,83851,2,32069699,01/09/2022,27,103609,54904,48705,31555,15575,15980
354,1,27132000,2,66017,1,17569783,01/09/2022,28.5,76660,40113,36547,21596,10646,10950
355,2,35209000,3,43229,2,22842621,01/09/2022,29.4,88280,46038,42242,25864,12608,13256
356,1,26613000,3,43670,1,17254780,01/09/2022,22.1,56163,29689,26474,18214,8872,9342
357,1,2296000,3,22049,1,1470351,01/09/2022,27,7263,3837,3426,2540,1279,1261
358,1,14882000,3,23969,1,9649331,01/09/2022,28.2,16645,8759,7886,5075,2484,2591
359,1,12306000,3,43646,1,7955254,01/09/2022,25,31469,16729,14740,9837,4899,4938
360,1,11667000,3,25065,1,7558485,01/09/2022,16.5,12729,6935,5794,4541,2296,2245
361,1,11574000,3,20299,1,7502801,01/09/2022,29.4,26015,13735,12280,7360,3633,3727
362,2,35936000,3,30200,2,23328200,01/09/2022,26.8,29903,15539,14364,9778,4798,4980
363,1,22983000,3,37093,1,14901857,01/09/2022,27.4,10504,5405,5099,3440,1722,1718
364,1,16615000,3,25346,1,10774404,01/09/2022,28.8,45134,23442,21692,13494,6690,6804
365,1,20396000,3,28336,1,13229064,01/09/2022,19.8,29130,15431,13699,9957,5019,4938
366,1,4331000,3,14539,1,2800611,01/09/2022,26,5812,3105,2707,1767,906,861
367,1,13162000,3,28802,1,8526498,01/09/2022,16.5,15851,8463,7388,5625,2839,2786
368,1,4956000,3,22178,1,3199222,01/09/2022,19.8,15298,8185,7113,4499,2268,2231
369,1,24790000,3,28336,1,16085164,01/09/2022,29.4,17525,9370,8155,5075,2488,2587
370,1,19430000,2,70148,1,12559352,01/09/2022,16.5,18915,10248,8667,6395,3217,3178
371,1,19488000,3,18446,1,12648754,01/09/2022,21,81848,43535,38313,23849,11894,11955
372,2,33896000,3,37677,2,21994723,01/09/2022,21,33726,17513,16213,11096,5372,5724
373,1,2439000,3,32551,1,1552799,01/09/2022,19.8,11168,5931,5237,3889,1954,1935
374,1,5100000,3,24709,1,3290291,01/09/2022,27,6341,3343,2998,2049,979,1070
375,1,19720000,3,13642,1,12804358,01/09/2022,21,45895,23816,22079,12162,5997,6165
376,1,5897000,3,34033,1,3799017,01/09/2022,24.7,6863,3664,3199,2612,1321,1291
377,1,9516000,3,26215,1,6159185,01/09/2022,21,10611,5602,5009,3876,1871,2005
378,1,3450000,3,17654,1,2224846,01/09/2022,28.2,14226,7514,6712,4380,2214,2166
379,1,4845000,3,23697,1,3125553,01/09/2022,21,7997,4114,3883,2359,1161,1198
380,1,4012000,3,11093,1,2596707,01/09/2022,25.3,4188,2243,1945,1509,761,748
381,1,25899000,2,55241,1,16779109,01/09/2022,26.8,15373,8115,7258,5203,2638,2565
382,1,14624000,3,22316,1,9483284,01/09/2022,28.6,14071,7408,6663,4497,2251,2246
383,1,1892000,3,20585,1,1209215,01/09/2022,15.7,6642,3720,2922,2058,1005,1053
384,1,5769000,3,6510,1,3743340,01/09/2022,26.4,11054,5638,5416,3563,1745,1818
385,3,200007000,1,406124,3,129598426,01/09/2022,18.3,1542232,806262,735970,402209,198130,204079
386,2,42635000,2,55649,2,27657101,01/09/2022,17.3,78264,40929,37335,23163,11368,11795
387,2,58266000,2,96734,2,37776166,01/09/2022,20.6,293825,155300,138525,93203,46206,46997
388,1,25529000,3,50687,1,16543163,01/09/2022,26.7,49578,26095,23483,16381,8171,8210
389,2,32762000,2,52681,2,21242619,01/09/2022,19.3,89314,47398,41916,25892,12760,13132
390,2,42478000,3,37247,2,27573453,01/09/2022,18.6,31315,16320,14995,10348,5100,5248
391,1,16018000,3,42836,1,10368864,01/09/2022,15.3,39203,20881,18322,12964,6446,6518
392,1,19449000,3,43075,1,12598775,01/09/2022,18.8,58957,31503,27454,19229,9506,9723
393,2,31456000,2,84790,2,20361610,01/09/2022,16.4,62849,33939,28910,17954,8876,9078
394,1,18767000,3,36617,1,12161933,01/09/2022,15.5,25468,13582,11886,8293,4136,4157
395,1,20724000,3,39457,1,13431143,01/09/2022,15.3,31599,16595,15004,11708,5967,5741
396,1,26903000,3,51321,1,17435629,01/09/2022,15.3,29123,15247,13876,9589,4733,4856
397,1,15330000,3,21011,1,9943489,01/09/2022,18.4,18110,9443,8667,6325,3046,3279
398,1,11526000,3,40521,1,7451379,01/09/2022,15.3,31695,16422,15273,11280,5582,5698
399,1,15808000,3,27391,1,10247809,01/09/2022,15.3,95322,48884,46438,32521,16133,16388
400,1,13917000,3,21330,1,9024720,01/09/2022,15.3,9358,5013,4345,2738,1323,1415
401,1,11432000,3,41913,1,7388887,01/09/2022,15.6,9149,4948,4201,2691,1357,1334
402,1,3320000,3,22049,1,2135951,01/09/2022,15.3,9913,5282,4631,3496,1711,1785
403,1,10205000,3,10956,1,6622294,01/09/2022,15.3,36620,18819,17801,10303,4961,5342
404,1,1783000,3,17610,1,1141340,01/09/2022,15.3,5276,2719,2557,1830,893,937
405,1,16978000,3,19038,1,11016662,01/09/2022,15.3,41455,21994,19461,13993,6843,7150
406,1,15114000,3,22357,1,9801743,01/09/2022,17.3,29613,15403,14210,9414,4672,4742
408,1,10180000,3,23088,1,6593912,01/09/2022,17.4,13922,7166,6756,5211,2590,2621
409,1,3297000,3,20461,1,2122589,01/09/2022,15.3,10960,5789,5171,3556,1785,1771
410,1,11387000,3,19038,1,7382512,01/09/2022,11.6,22904,12086,10818,7644,3743,3901
411,1,6776000,3,22818,1,4381582,01/09/2022,15.3,11776,6077,5699,3730,1832,1898
412,1,1527000,3,8759,1,983791,01/09/2022,15.3,16797,8560,8237,5425,2652,2773
413,1,3382000,3,23385,1,2174915,01/09/2022,15.3,19648,10052,9596,6751,3334,3417
414,1,12850000,3,19977,1,8332523,01/09/2022,24.8,19341,10302,9039,6428,3158,3270
415,1,3180000,3,18808,1,2048192,01/09/2022,14.1,11487,6208,5279,3749,1855,1894
416,1,5422000,3,17105,1,3507195,01/09/2022,15.3,5703,2985,2718,1959,971,988
417,1,1573000,3,19989,1,1002461,01/09/2022,15.3,6644,3435,3209,2305,1130,1175
418,1,3192000,3,15050,1,2059750,01/09/2022,15.3,7491,3982,3509,2583,1266,1317
419,1,1702000,3,14051,1,1092249,01/09/2022,15.3,8481,4360,4121,2849,1391,1458
420,1,20967000,3,34767,1,13593783,01/09/2022,18.3,46996,24240,22756,12187,6012,6175
421,1,2527000,3,20587,1,1621963,01/09/2022,20.9,8445,4468,3977,3005,1505,1500
422,1,5348000,3,21749,1,3454451,01/09/2022,16.9,5612,3027,2585,1851,938,913
423,1,6456000,3,18616,1,4177784,01/09/2022,25.3,5276,2719,2557,1830,893,937
424,3,167632000,1,236354,3,108724446,01/09/2022,19.5,794789,407239,387550,199480,98049,101431
425,2,40026000,2,66598,2,25950302,01/09/2022,15.9,177719,91525,86194,50219,24680,25539
426,1,16937000,3,24986,1,10984064,01/09/2022,15.9,34955,18206,16749,9854,4805,5049
427,1,2112000,3,21705,1,1351095,01/09/2022,16.4,115264,60166,55098,28758,14392,14366
428,1,13314000,3,24080,1,8630020,01/09/2022,15.9,16795,8697,8098,5436,2628,2808
429,1,6271000,3,21935,1,4054215,01/09/2022,19.5,13390,6831,6559,4033,1966,2067
430,1,8597000,3,24328,1,5563722,01/09/2022,20.2,7953,4224,3729,2375,1195,1180
431,1,7086000,3,19231,1,4586669,01/09/2022,24.5,15512,8121,7391,5093,2493,2600
432,2,51884000,3,46763,2,33677837,01/09/2022,28.9,169028,86790,82238,45879,22689,23190
433,3,140611000,1,150426,3,91246724,01/09/2022,29.6,888797,441181,447616,247410,121384,126026
434,2,65329000,2,73288,2,42390562,01/09/2022,27.8,304942,149380,155562,85665,42398,43267
435,1,23289000,3,46989,1,15090861,01/09/2022,28.2,84519,42292,42227,24955,12440,12515
436,1,14335000,3,22746,1,9295004,01/09/2022,28.1,30754,15948,14806,10320,5221,5099
437,3,123500000,1,133413,3,80141587,01/09/2022,19.8,845941,437370,408571,227808,112567,115241
438,2,52368000,2,55902,2,33983298,01/09/2022,28.1,136351,71718,64633,38918,19062,19856
439,1,24358000,3,45117,1,15787583,01/09/2022,21.8,86686,44901,41785,27406,13467,13939
440,1,25879000,3,46742,1,16774608,01/09/2022,24.9,58158,30570,27588,17715,8934,8781
441,1,22974000,2,57574,1,14875526,01/09/2022,28.6,24258,12834,11424,7258,3602,3656
442,1,11572000,3,21653,1,7500147,01/09/2022,27.4,24454,12691,11763,7326,3576,3750
443,1,19689000,3,28880,1,12768970,01/09/2022,17.9,310192,159130,151062,94872,46787,48085
444,1,2776000,3,26879,1,1777521,01/09/2022,19.8,14340,7646,6694,4731,2430,2301
445,2,53877000,2,72813,2,34947237,01/09/2022,27.4,15341,8078,7263,4842,2416,2426
446,1,4525000,3,19343,1,2921907,01/09/2022,28.6,8045,4283,3762,2501,1247,1254
447,1,8403000,3,24838,1,5437112,01/09/2022,28.6,6644,3540,3104,2086,1058,1028
448,1,3965000,3,21846,1,2555404,01/09/2022,27.4,16582,8647,7935,5030,2477,2553
449,1,22085000,2,64566,1,14290684,01/09/2022,30,30796,15740,15056,9239,4503,4736
450,2,56811000,2,84819,2,36842331,01/09/2022,30.6,77849,40866,36983,21990,10871,11119
451,2,30727000,3,39277,2,19933273,01/09/2022,28.6,65215,33971,31244,19700,9733,9967
452,3,105279000,1,143804,3,68287546,01/09/2022,27.4,441975,227109,214866,122010,60145,61865
453,3,301130000,1,234042,3,195500458,01/09/2022,30.9,808416,416251,392165,234633,115277,119356
454,2,71622000,1,125606,2,46428694,01/09/2022,31.1,298009,154344,143665,83869,41238,42631
455,1,14820000,3,22059,1,9610941,01/09/2022,30.4,33924,17240,16684,10629,5267,5362
456,1,10314000,3,23555,1,6680545,01/09/2022,29.8,14772,7516,7256,4444,2199,2245
457,1,16702000,3,31749,1,10824551,01/09/2022,29.8,19742,9908,9834,6831,3367,3464
458,1,9416000,3,22053,1,6098347,01/09/2022,30.5,12848,6693,6155,3711,1831,1880
459,1,9567000,3,23318,1,6195232,01/09/2022,28.5,5457,2839,2618,1473,755,718
460,1,5327000,3,23785,1,3438765,01/09/2022,28.5,5926,3043,2883,1700,842,858
461,1,9641000,3,19504,1,6247146,01/09/2022,30.4,17097,8801,8296,5359,2662,2697
462,1,11707000,3,42598,1,7566952,01/09/2022,30,28239,14113,14126,8795,4312,4483
463,1,10836000,3,23337,1,7020063,01/09/2022,29,16934,8502,8432,5395,2626,2769
464,1,12675000,3,35884,1,8202866,01/09/2022,29.8,11851,5973,5878,3739,1841,1898
465,1,6247000,3,18229,1,4042321,01/09/2022,30.8,25157,12582,12575,8765,4230,4535
466,1,3702000,3,22370,1,2383930,01/09/2022,29.4,6055,3107,2948,1652,803,849
467,1,3037000,3,22394,1,1951656,01/09/2022,30.8,22421,11364,11057,6263,3134,3129
468,1,1933000,3,22279,1,1234171,01/09/2022,29,9864,5093,4771,3123,1529,1594
469,1,3226000,3,12763,1,2084137,01/09/2022,29.1,7888,4037,3851,3058,1509,1549
470,1,3842000,3,18228,1,2479072,01/09/2022,28.5,5524,2885,2639,1817,894,923
472,1,3013000,3,19784,1,1938666,01/09/2022,30.3,10328,5288,5040,3690,1794,1896
473,1,948000,3,21305,1,594895,01/09/2022,29.1,4810,2229,2581,1556,759,797
474,2,74132000,1,135669,2,48050131,01/09/2022,28.1,329404,168547,160857,90108,44605,45503
475,3,142345000,1,238966,3,92285284,01/09/2022,30.9,855563,431621,423942,240318,117646,122672
476,2,29094000,2,77276,2,18833824,01/09/2022,29.2,117253,59414,57839,33098,16300,16798
477,2,55783000,2,59568,2,36199382,01/09/2022,30.4,176685,87738,88947,53884,26504,27380
478,2,60230000,1,116455,2,39033045,01/09/2022,25.4,261137,131158,129979,84004,41439,42565
479,2,31829000,3,43883,2,20644967,01/09/2022,30.5,120926,61958,58968,34805,17098,17707
480,1,22159000,3,34097,1,14369253,01/09/2022,31.1,67604,34141,33463,21101,10330,10771
481,1,11376000,3,22745,1,7371655,01/09/2022,30.1,38886,19733,19153,11641,5731,5910
482,1,13297000,3,25366,1,8617684,01/09/2022,29.5,30324,15540,14784,8298,4088,4210
483,1,24384000,3,34907,1,15814693,01/09/2022,23.7,91029,45722,45307,30379,15003,15376
484,1,20711000,3,29669,1,13432481,01/09/2022,31.7,62301,30877,31424,20494,10127,10367
485,1,2670000,3,22049,1,1713451,01/09/2022,25.2,12987,6460,6527,4296,2156,2140
486,1,12339000,3,26329,1,7994021,01/09/2022,23.6,38113,19225,18888,12385,6138,6247
487,1,2177000,3,22049,1,1393001,01/09/2022,31.2,12372,6340,6032,3845,1851,1994
488,1,10907000,3,22312,1,7067238,01/09/2022,30.2,39474,19169,20305,14904,7336,7568
489,1,11865000,3,19054,1,7693196,01/09/2022,21.3,30429,15578,14851,9786,4826,4960
490,1,4449000,3,21736,1,2870114,01/09/2022,29.5,13153,6653,6500,4059,2009,2050
491,1,4651000,3,19188,1,3003962,01/09/2022,29.6,11440,5836,5604,4121,2095,2026
492,1,2490000,3,19129,1,1599371,01/09/2022,31.3,4787,2437,2350,1357,684,673
493,2,91083000,1,157259,2,59046691,01/09/2022,25.9,340060,178122,161938,86078,42456,43622
494,2,43694000,3,34179,2,28366921,01/09/2022,28,43035,22773,20262,11996,6054,5942
495,1,18859000,3,35155,1,12223195,01/09/2022,27.2,27182,14325,12857,8434,4220,4214
496,1,14314000,3,18654,1,9285446,01/09/2022,28,21003,10909,10094,6452,3209,3243
497,1,21415000,3,38274,1,13881476,01/09/2022,27.6,31435,16316,15119,9125,4445,4680
498,1,15190000,3,41346,1,9832154,01/09/2022,27.2,29068,15153,13915,8638,4280,4358
499,1,16803000,3,23218,1,10898732,01/09/2022,27.4,25555,13197,12358,7191,3479,3712
500,1,5978000,3,18435,1,3867265,01/09/2022,26.7,13944,7272,6672,4420,2177,2243
501,1,19598000,3,22745,1,12715955,01/09/2022,27.8,34946,17956,16990,11208,5422,5786
502,1,12642000,3,26947,1,8190353,01/09/2022,26.4,16679,8618,8061,4633,2284,2349
503,2,58853000,2,80483,2,38173967,01/09/2022,27.9,297373,155718,141655,71865,35366,36499
504,3,142842000,1,185923,3,92661377,01/09/2022,27.9,691557,348387,343170,213267,104895,108372
505,2,73915000,2,68756,2,47975994,01/09/2022,28.3,416055,211059,204996,132268,65355,66913
506,1,18704000,3,33054,1,12124546,01/09/2022,28.4,111314,55902,55412,35576,17423,18153
507,2,61888000,2,86672,2,40140528,01/09/2022,26.8,332100,171749,160351,94911,46503,48408
508,1,28217000,3,48533,1,18292517,01/09/2022,28.6,79515,41903,37612,21445,10720,10725
509,2,29109000,2,66703,2,18854147,01/09/2022,27.5,205933,107685,98248,49242,24249,24993
510,1,12250000,3,23089,1,7939411,01/09/2022,27.9,48172,24667,23505,15031,7399,7632
511,1,8432000,3,18694,1,5462106,01/09/2022,28.4,18592,8945,9647,4116,2046,2070
512,2,29320000,3,32784,2,19025216,01/09/2022,28,79824,40689,39135,24808,12213,12595
513,1,2334000,3,20349,1,1496751,01/09/2022,28.4,10327,5388,4939,2996,1506,1490
514,1,7140000,3,20367,1,4620633,01/09/2022,28.4,28215,14347,13868,9384,4582,4802
515,1,5473000,3,6355,1,3551095,01/09/2022,27,10993,5737,5256,3544,1803,1741
517,1,24894000,3,39363,1,16141737,01/09/2022,14.7,53373,27810,25563,15744,7755,7989
518,2,33933000,2,62825,2,21993625,01/09/2022,18.3,13555,7357,6198,3051,1547,1504
519,1,25045000,3,38852,1,16240398,01/09/2022,14.8,59871,31271,28600,19112,9469,9643
520,2,43650000,2,72580,2,28299920,01/09/2022,16.8,47632,25410,22222,12563,6265,6298
521,1,18564000,3,28209,1,12038391,01/09/2022,18.1,45587,23716,21871,14000,6913,7087
522,1,11759000,3,25234,1,7618116,01/09/2022,14,37704,19683,18021,12453,6131,6322
523,1,13810000,3,14464,1,8962036,01/09/2022,14.7,70224,35655,34569,24421,12033,12388
524,1,3259000,3,21317,1,2097033,01/09/2022,14.7,17978,9382,8596,6248,3105,3143
525,1,1536000,3,24226,1,974174,01/09/2022,14.7,13401,6929,6472,4288,2149,2139
526,1,1464000,3,16083,1,935517,01/09/2022,14.7,30417,15670,14747,9405,4719,4686
527,1,7353000,3,29856,1,4749594,01/09/2022,14.7,28657,14853,13804,9078,4552,4526
528,1,1191000,3,11206,1,762944,01/09/2022,14.7,1583,826,757,480,230,250
529,2,50465000,2,78126,2,32724124,01/09/2022,22.2,139075,74465,64610,36819,18286,18533
530,2,58529000,2,80726,2,37963124,01/09/2022,20.7,120500,65043,55457,29046,14403,14643
531,2,59846000,2,53941,2,38845959,01/09/2022,26.8,101336,54039,47297,24763,12096,12667
532,3,125781000,1,298807,3,81458843,01/09/2022,27.1,405952,215818,190134,89205,43880,45325
533,2,54787000,2,99623,2,35511927,01/09/2022,26.3,212540,111746,100794,51580,25268,26312
534,2,56468000,1,129664,2,36574536,01/09/2022,27.7,180057,96347,83710,45301,22589,22712
535,2,67964000,1,205013,2,43971587,01/09/2022,20.1,443063,237967,205096,110147,54509,55638
536,1,22530000,3,22942,1,14621558,01/09/2022,27,33226,17650,15576,10241,5095,5146
537,1,9369000,3,21255,1,6068595,01/09/2022,27.1,15512,8193,7319,4859,2440,2419
538,2,38218000,2,61635,2,24780065,01/09/2022,25.3,64445,34215,30230,17692,8626,9066
539,2,34808000,3,49681,2,22575519,01/09/2022,27.4,48567,25769,22798,13570,6693,6877
540,1,21545000,3,25105,1,13979145,01/09/2022,14.4,42451,22342,20109,14824,7241,7583
541,1,16627000,3,22569,1,10784981,01/09/2022,28,41588,21739,19849,12522,6161,6361
543,1,22189000,3,46190,1,14376660,01/09/2022,27.7,55452,29697,25755,14940,7380,7560
544,1,1725000,3,22140,1,1099110,01/09/2022,27.1,6076,3180,2896,1703,844,859
545,2,38697000,2,59378,2,25093672,01/09/2022,27.7,64692,34002,30690,19678,9778,9900
546,1,4023000,3,25665,1,2589285,01/09/2022,27.3,22760,12125,10635,6420,3229,3191
547,1,14642000,3,28988,1,9488312,01/09/2022,27.8,25608,13480,12128,7723,3870,3853
548,1,9828000,3,43590,1,6344610,01/09/2022,25.3,15733,8506,7227,4079,2054,2025
549,1,7435000,3,24365,1,4808385,01/09/2022,20.7,41785,22480,19305,10854,5445,5409
550,1,9053000,3,32340,1,5852110,01/09/2022,27.6,13225,6946,6279,3476,1669,1807
551,1,13938000,3,37365,1,9022335,01/09/2022,24,28655,15243,13412,8764,4302,4462
552,1,5491000,3,29533,1,3539617,01/09/2022,25.1,17727,9423,8304,4199,2068,2131
553,1,12976000,2,81024,1,8353376,01/09/2022,27.1,8969,4883,4086,2821,1444,1377
554,1,10179000,3,23692,1,6592658,01/09/2022,27.2,16758,8967,7791,4993,2542,2451
555,2,32891000,3,46153,2,21332997,01/09/2022,26.6,47035,25085,21950,12872,6289,6583
556,1,17644000,3,28832,1,11439768,01/09/2022,26.2,55720,29557,26163,14521,7123,7398
557,1,18770000,3,24526,1,12175974,01/09/2022,25.9,46909,24866,22043,15156,7483,7673
558,1,11601000,3,23743,1,7516907,01/09/2022,25.9,33986,17827,16159,9043,4421,4622
559,1,12841000,3,28547,1,8318103,01/09/2022,20.7,34847,18666,16181,8943,4380,4563
560,1,12405000,3,29012,1,8034238,01/09/2022,26.6,14304,7545,6759,4455,2182,2273
561,1,7895000,3,26329,1,5105421,01/09/2022,26.6,20797,10995,9802,4991,2418,2573
562,1,16273000,3,23899,1,10553551,01/09/2022,27.3,30232,15727,14505,8913,4281,4632
563,1,20378000,2,55708,1,13189992,01/09/2022,26.5,20165,10621,9544,5395,2701,2694
564,1,2610000,3,15671,1,1680829,01/09/2022,27.7,20380,10692,9688,6259,3127,3132
565,1,11206000,3,22976,1,7260924,01/09/2022,14.6,21640,11976,9664,7433,3885,3548
566,1,19066000,3,32943,1,12359957,01/09/2022,17.9,33402,17876,15526,9753,4761,4992
567,1,18092000,3,31367,1,11728433,01/09/2022,26.7,26236,13620,12616,8067,3962,4105
568,1,3428000,3,17228,1,2210972,01/09/2022,26.4,4405,2358,2047,1451,735,716
569,1,3403000,3,18808,1,2193142,01/09/2022,26,13716,7109,6607,3981,1920,2061
570,1,11381000,3,26795,1,7370855,01/09/2022,26.6,5653,2987,2666,1709,826,883
571,1,9528000,3,32291,1,6160909,01/09/2022,27.2,21318,11472,9846,5688,2873,2815
572,1,10117000,3,23521,1,6552529,01/09/2022,26.6,14582,7621,6961,4539,2262,2277
573,1,1705000,3,22351,1,1085899,01/09/2022,26.8,6219,3311,2908,1883,941,942
574,1,8837000,3,27870,1,5716180,01/09/2022,27.1,31856,17018,14838,8563,4318,4245
575,1,15467000,3,24054,1,10029496,01/09/2022,20.7,35893,18883,17010,11399,5600,5799
576,1,15950000,3,19735,1,10347765,01/09/2022,27.2,19272,10328,8944,5163,2534,2629
577,1,15255000,3,19848,1,9895902,01/09/2022,14.1,16364,8711,7653,5250,2654,2596
578,1,10115000,3,21750,1,6553000,01/09/2022,27.1,2820,1449,1371,720,341,379
579,1,1841000,3,16540,1,1180110,01/09/2022,26.8,4654,2510,2144,1296,630,666
580,1,1634000,3,22006,1,1040094,01/09/2022,14.1,21585,11243,10342,6456,3197,3259
581,1,1650000,3,18464,1,1054036,01/09/2022,26.6,6888,3543,3345,1840,922,918
582,1,1734000,3,23247,1,1103853,01/09/2022,26.5,21391,11404,9987,5619,2742,2877
583,1,1333000,3,22178,1,844272,01/09/2022,27.3,9668,5030,4638,2384,1141,1243
584,1,17316000,3,24424,1,11230976,01/09/2022,27.1,13995,7311,6684,4212,2070,2142
585,1,4872000,3,22651,1,3144149,01/09/2022,26.2,6838,3583,3255,1791,891,900
586,1,1611000,3,22178,1,1024972,01/09/2022,26.5,5681,3058,2623,1606,823,783
587,1,7435000,3,23412,1,4809338,01/09/2022,14.1,13966,7679,6287,3739,1859,1880
588,1,12070000,3,13220,1,7832280,01/09/2022,27.2,28076,14773,13303,7550,3752,3798
589,1,5712000,3,24174,1,3688626,01/09/2022,13,34039,18008,16031,8858,4334,4524
590,1,2061000,3,20101,1,1319549,01/09/2022,20.7,15807,8231,7576,5949,2955,2994
591,1,1111000,3,14258,1,707892,01/09/2022,26.2,10581,5508,5073,2907,1418,1489
592,1,3343000,3,25053,1,2147897,01/09/2022,18.1,9554,4935,4619,2707,1302,1405
593,1,12255000,2,53314,1,7912436,01/09/2022,25.9,9988,5342,4646,2237,1127,1110
594,1,2420000,3,14180,1,1558820,01/09/2022,27.6,7578,3984,3594,2088,1031,1057
595,1,2362000,3,18808,1,1516492,01/09/2022,18.9,8005,4106,3899,2599,1296,1303
596,1,2961000,3,21975,1,1902675,01/09/2022,27.2,24085,12288,11797,7909,3780,4129
597,1,4252000,3,22486,1,2741314,01/09/2022,26.5,7455,4054,3401,2223,1145,1078
598,1,917000,3,8676,1,587374,01/09/2022,26.8,17919,9538,8381,4548,2298,2250
599,1,4207000,3,24262,1,2710288,01/09/2022,27.7,15305,8066,7239,4706,2332,2374
600,3,139670000,1,238048,3,90547452,01/09/2022,28.3,921771,479309,442462,222551,109790,112761
601,1,14919000,3,22173,1,9675177,01/09/2022,25.7,26081,13338,12743,7626,3791,3835
602,2,30352000,3,25395,2,19703405,01/09/2022,28.7,56494,29131,27363,17460,8617,8843
603,1,16619000,3,19848,1,10782502,01/09/2022,28,52593,26982,25611,16883,8307,8576
604,1,6099000,3,24641,1,3939709,01/09/2022,28.3,41965,21110,20855,11192,5453,5739
605,1,8827000,3,22477,1,5715073,01/09/2022,28.8,26175,13553,12622,8885,4301,4584
606,1,12056000,3,27551,1,7808849,01/09/2022,27.4,35183,17868,17315,10650,5230,5420
607,1,9875000,3,25882,1,6392868,01/09/2022,26.4,56409,28489,27920,16919,8292,8627
608,1,9046000,3,14262,1,5865638,01/09/2022,26.7,139753,70456,69297,45077,22298,22779
609,1,7423000,3,23503,1,4801447,01/09/2022,27.2,17841,9042,8799,5372,2677,2695
610,1,7018000,3,22108,1,4539592,01/09/2022,26.5,28461,14574,13887,9148,4533,4615
611,2,37126000,2,53807,2,24078093,01/09/2022,18.8,143281,73905,69376,47529,23519,24010
612,2,39883000,2,92523,2,25831427,01/09/2022,14.8,138444,72335,66109,38201,18773,19428
613,1,11617000,3,24471,1,7526579,01/09/2022,19.6,22295,11690,10605,8176,4115,4061
614,1,12603000,3,46349,1,8145601,01/09/2022,17.2,25068,12776,12292,8673,4237,4436
615,1,2459000,3,19563,1,1578787,01/09/2022,19,15291,7886,7405,5051,2477,2574
616,1,4874000,3,22623,1,3145477,01/09/2022,18.3,38193,19467,18726,13775,6896,6879
617,1,10007000,3,20339,1,6484211,01/09/2022,20.2,46132,23831,22301,13972,6871,7101
618,1,1843000,3,21935,1,1176015,01/09/2022,22.5,13641,7027,6614,4307,2133,2174
1,3,101651000,1,179775,3,65893375,01/08/2022,22.5,863893,444725,419168,260350,128225,132125
2,1,16829000,3,13865,1,10924985,01/08/2022,22.5,31963,16433,15530,11390,5609,5781
3,1,10378000,3,23523,1,6722177,01/08/2022,21.2,63805,32406,31399,23397,11652,11745
4,1,10044000,3,23375,1,6505225,01/08/2022,22.5,21049,10874,10175,7097,3529,3568
5,1,5586000,3,25651,1,3605249,01/08/2022,21,32035,16367,15668,10989,5374,5615
6,3,207310000,1,286161,3,134465339,01/08/2022,37.6,854186,425977,428209,227917,112151,115766
7,3,427896000,1,526320,3,277606080,01/08/2022,23.6,1810645,899293,911352,503963,246971,256992
8,2,95689000,2,88486,2,62109364,01/08/2022,22.8,330652,167339,163313,86895,42903,43992
9,2,35128000,3,27477,2,22805723,01/08/2022,27.2,81059,40420,40639,23492,11470,12022
10,2,36656000,3,50943,2,23775457,01/08/2022,23,100660,49935,50725,28067,13772,14295
11,1,19477000,3,22701,1,12637349,01/08/2022,35.4,19081,9476,9605,5934,2909,3025
12,2,80410000,1,122262,2,52144238,01/08/2022,31.8,250141,126245,123896,65670,32312,33358
13,2,55368000,2,81805,2,35907395,01/08/2022,28.3,136285,66083,70202,42780,21001,21779
14,2,77856000,2,103150,2,50503250,01/08/2022,30.1,202694,98608,104086,64935,31858,33077
15,1,24543000,3,35302,1,15917648,01/08/2022,30.1,43805,22160,21645,13050,6507,6543
16,1,25891000,2,71299,1,16757851,01/08/2022,32.2,16311,8010,8301,4984,2435,2549
17,1,10305000,3,26272,1,6671978,01/08/2022,30,14357,6822,7535,3854,1925,1929
18,1,3004000,3,26409,1,1926191,01/08/2022,23.8,13596,6842,6754,4196,2086,2110
19,1,9439000,3,25875,1,6109475,01/08/2022,27.9,13596,6842,6754,4196,2086,2110
20,1,3489000,3,27457,1,2240393,01/08/2022,27.8,7185,3509,3676,2099,1015,1084
21,2,47274000,2,63413,2,30664687,01/08/2022,28.9,191238,97313,93925,52600,25862,26738
22,2,46564000,2,65134,2,30201466,01/08/2022,29.2,249623,130524,119099,66498,32635,33863
23,1,27892000,3,26258,1,18103542,01/08/2022,29.3,31375,16375,15000,10682,5317,5365
24,1,18331000,3,27051,1,11888099,01/08/2022,28.6,35799,18291,17508,11962,5883,6079
25,1,13543000,3,27607,1,8775343,01/08/2022,29.6,15949,8217,7732,4538,2234,2304
26,2,84306000,2,89804,2,54709096,01/08/2022,27.5,217550,113613,103937,65123,32048,33075
27,2,47541000,3,46548,2,30855102,01/08/2022,18.2,183509,96930,86579,60413,30246,30167
28,2,50219000,2,66612,2,32575738,01/08/2022,20.7,113479,60064,53415,36594,18199,18395
29,3,110560000,2,92842,3,71771158,01/08/2022,26.7,578830,303756,275074,166456,82025,84431
30,2,39458000,3,32109,2,25615591,01/08/2022,28.7,51797,27093,24704,17614,8812,8802
31,2,62265000,1,118394,2,40353856,01/08/2022,27.3,38087,20017,18070,11916,5833,6083
32,1,13950000,3,22227,1,9045273,01/08/2022,29.6,32109,16780,15329,10495,5074,5421
33,1,24580000,3,22845,1,15954155,01/08/2022,24.7,21727,11415,10312,7786,3890,3896
34,1,17389000,3,28208,1,11274642,01/08/2022,27,49201,25651,23550,16539,8102,8437
35,1,24581000,3,41133,1,15936517,01/08/2022,26.2,37546,19668,17878,11791,5836,5955
36,1,22141000,2,76329,1,14315321,01/08/2022,20.1,47688,25247,22441,17870,8920,8950
37,1,5217000,3,23477,1,3367573,01/08/2022,28.7,55931,28786,27145,18430,9082,9348
38,1,12491000,3,26754,1,8092396,01/08/2022,24.8,29018,15064,13954,10291,5191,5100
39,1,10366000,3,40014,1,6697886,01/08/2022,25.6,18219,9592,8627,5806,2838,2968
40,1,14099000,3,26194,1,9138156,01/08/2022,28.6,15244,8058,7186,4848,2429,2419
41,1,5888000,3,22538,1,3804662,01/08/2022,29.9,25366,13345,12021,7752,3823,3929
42,1,17550000,3,23632,1,11383868,01/08/2022,27.1,19271,9996,9275,6517,3095,3422
43,1,5061000,3,20951,1,3268699,01/08/2022,28.4,7662,4073,3589,2321,1153,1168
45,3,305702000,1,247819,3,198458481,01/08/2022,27.1,1501551,750157,751394,459910,225614,234296
46,3,119083000,1,176678,3,77227272,01/08/2022,25.9,925762,474776,450986,250961,123448,127513
47,2,33742000,3,49908,2,21882392,01/08/2022,27.8,128548,65838,62710,37721,18411,19310
48,1,26676000,3,41070,1,17298330,01/08/2022,20.6,135586,69677,65909,41627,20458,21169
49,2,35068000,2,61809,2,22732391,01/08/2022,23.7,113843,59214,54629,34117,16974,17143
50,1,5945000,3,22364,1,3841886,01/08/2022,28.2,23140,11693,11447,7155,3499,3656
51,1,9756000,3,26009,1,6315391,01/08/2022,24.7,35087,17902,17185,11563,5663,5900
52,1,14853000,3,34486,1,9619964,01/08/2022,26.7,42019,21548,20471,12599,6234,6365
53,1,10905000,3,30079,1,7058171,01/08/2022,31.3,22066,11231,10835,6719,3420,3299
54,1,9818000,3,22288,1,6359412,01/08/2022,17.3,17410,9121,8289,6393,3204,3189
55,1,2613000,3,22745,1,1675705,01/08/2022,26.4,22568,11549,11019,7200,3540,3660
56,1,6355000,3,23626,1,4107124,01/08/2022,20.4,15054,7516,7538,5557,2768,2789
57,1,4184000,2,70707,1,2648893,01/08/2022,23.1,8253,4210,4043,2801,1419,1382
58,1,5519000,3,35702,1,3551648,01/08/2022,19,7834,4065,3769,2439,1200,1239
59,1,2305000,3,23014,1,1475236,01/08/2022,17.1,14755,7617,7138,4907,2427,2480
60,1,14009000,3,29761,1,9076089,01/08/2022,24.3,62038,31762,30276,19262,9511,9751
61,3,102155000,1,126092,3,66274658,01/08/2022,29.9,690193,353744,336449,203574,99881,103693
62,3,141804000,1,185388,3,91987212,01/08/2022,23.5,864431,434753,429678,267728,131619,136109
63,2,45663000,2,79655,2,29601295,01/08/2022,31.3,237169,119538,117631,71348,35023,36325
64,2,51504000,2,72549,2,33405051,01/08/2022,32,173959,86825,87134,55826,27459,28367
65,1,10639000,3,24838,1,6890512,01/08/2022,30.3,39058,19755,19303,11201,5479,5722
66,3,117515000,1,176454,3,76208296,01/08/2022,28,59762,30506,29256,20025,9931,10094
67,1,15794000,3,39096,1,10227004,01/08/2022,29.9,49490,25496,23994,16916,8460,8456
68,1,28807000,2,57648,1,18666902,01/08/2022,30.4,160225,79799,80426,53549,26489,27060
69,1,15354000,3,22306,1,9957794,01/08/2022,24,114010,56192,57818,38156,18905,19251
70,1,26052000,3,42266,1,16891534,01/08/2022,29.2,75242,37695,37547,23792,11778,12014
71,1,13378000,3,25340,1,8670360,01/08/2022,30.8,59196,29915,29281,18125,8949,9176
72,1,14564000,3,28365,1,9438235,01/08/2022,29.5,32704,16713,15991,11320,5572,5748
73,1,6656000,3,25985,1,4300415,01/08/2022,30.3,23413,11884,11529,7157,3552,3605
74,1,10863000,3,24028,1,7036922,01/08/2022,30.5,38992,19602,19390,13022,6299,6723
75,1,1934000,3,23905,1,1233195,01/08/2022,30.4,27314,13703,13611,9005,4397,4608
76,2,59834000,2,65483,2,38826617,01/08/2022,26,146965,75962,71003,46271,22786,23485
77,2,33009000,3,43877,2,21411973,01/08/2022,30.5,88337,44762,43575,34686,17254,17432
78,2,47237000,2,63412,2,30640638,01/08/2022,30.2,159853,80569,79284,57402,28064,29338
79,1,2974000,3,22408,1,1910692,01/08/2022,25.9,9746,4912,4834,3336,1602,1734
80,1,2739000,3,24516,1,1755834,01/08/2022,29.6,15368,7632,7736,5699,2779,2920
81,1,1789000,3,9284,1,1153566,01/08/2022,27.5,147496,76348,71148,49524,24280,25244
82,1,1367000,3,24095,1,864455,01/08/2022,27.9,14892,7420,7472,5365,2615,2750
83,1,8668000,3,25459,1,5608741,01/08/2022,29.7,34798,17459,17339,10865,5211,5654
84,2,43190000,1,180312,2,27893188,01/08/2022,19.5,432205,227255,204950,86717,42372,44345
85,2,43961000,1,173733,2,28400917,01/08/2022,19.5,759003,398068,360935,168014,83097,84917
86,3,101101000,1,319298,3,65396352,01/08/2022,20.1,1173351,609477,563874,261635,129105,132530
87,1,28843000,2,62045,1,18685905,01/08/2022,19.9,414470,219003,195467,75588,37198,38390
88,1,19456000,2,57687,1,12588713,01/08/2022,18.1,186693,97615,89078,46165,22603,23562
89,3,166945000,1,361917,3,108152333,01/08/2022,19.6,1835486,947835,887651,451632,222341,229291
90,2,54913000,1,115408,2,35578042,01/08/2022,19.6,614447,325337,289110,113945,55951,57994
91,1,28974000,2,85147,1,18747953,01/08/2022,19.4,434153,232032,202121,62030,30612,31418
92,2,56234000,1,120506,2,36431594,01/08/2022,18.6,323771,167274,156497,83659,40990,42669
93,2,47560000,2,81483,2,30832517,01/08/2022,17.6,404695,212343,192352,85496,42058,43438
94,1,28854000,1,147961,1,18607139,01/08/2022,19.3,443704,233586,210118,95713,47173,48540
95,2,66953000,1,270842,2,43248608,01/08/2022,19.5,545884,284933,260951,101794,50260,51534
96,1,15936000,2,56879,1,10301521,01/08/2022,18,429481,220393,209088,105785,52018,53767
97,1,9338000,3,46086,1,6023614,01/08/2022,15,246428,128767,117661,58169,28791,29378
98,1,13321000,3,31154,1,8627496,01/08/2022,15,599935,314284,285651,130174,64060,66114
99,3,128458000,1,168111,3,83329589,01/08/2022,22.3,616068,317266,298802,191866,94056,97810
100,2,72443000,2,94781,2,46993169,01/08/2022,22.4,301742,154079,147663,97495,48007,49488
101,1,10519000,3,20318,1,6817032,01/08/2022,27.6,96243,49040,47203,29383,14345,15038
102,1,16690000,3,32857,1,10815643,01/08/2022,24.2,30063,15334,14729,10450,5151,5299
103,1,1708000,2,92852,1,1017348,01/08/2022,28.2,3222,1654,1568,1247,637,610
104,1,13217000,2,56198,1,8534852,01/08/2022,20.2,17967,9205,8762,6003,2945,3058
105,1,2506000,3,21273,1,1607627,01/08/2022,20.9,11943,6311,5632,3854,1993,1861
106,1,2223000,2,93828,1,1351122,01/08/2022,24.4,12850,6538,6312,4678,2267,2411
107,2,41614000,2,100648,2,26948452,01/08/2022,15.7,26678,13733,12945,10032,4897,5135
108,3,175112000,1,243753,3,113579047,01/08/2022,16,223876,119352,104524,50306,24928,25378
109,2,62031000,1,177842,2,40142308,01/08/2022,17.7,515353,266081,249272,126007,61695,64312
110,3,100918000,1,315232,3,65281468,01/08/2022,18,776220,402522,373698,193769,95439,98330
111,2,62213000,2,90747,2,40347703,01/08/2022,16.8,84298,43745,40553,23019,11356,11663
112,2,47783000,2,56301,2,31002649,01/08/2022,18.5,30929,15848,15081,8319,4034,4285
113,2,32801000,1,118981,2,21201669,01/08/2022,17.8,293245,152241,141004,70657,34731,35926
114,2,61132000,1,212029,2,39523771,01/08/2022,17.2,658907,338453,320454,150053,73914,76139
115,1,25185000,3,23886,1,16346364,01/08/2022,17.2,117995,60165,57830,29983,14851,15132
116,3,173548000,1,333251,3,112472949,01/08/2022,15.9,1643623,845932,797691,437489,216020,221469
117,2,75571000,1,150849,2,48970301,01/08/2022,20.4,368585,190133,178452,107535,52900,54635
118,2,46908000,2,64685,2,30425515,01/08/2022,9.7,174704,91497,83207,54449,28355,26094
119,1,19771000,3,44542,1,12806608,01/08/2022,7.3,2931,1520,1411,975,512,463
120,2,57879000,2,102921,2,37518429,01/08/2022,9.7,35491,18986,16505,7987,3993,3994
121,2,65322000,1,145691,2,42313609,01/08/2022,16.8,703215,359601,343614,230612,113552,117060
122,2,62994000,1,174889,2,40771211,01/08/2022,18,18226,9300,8926,5308,2603,2705
123,2,51549000,2,60370,2,33446480,01/08/2022,19.5,1072676,556998,515678,265425,131078,134347
124,1,21934000,3,19249,1,14237851,01/08/2022,20.5,14038,7254,6784,3763,1910,1853
125,2,73094000,2,84085,2,47427015,01/08/2022,9.7,174704,91497,83207,54449,28355,26094
126,2,53939000,3,32926,2,35027424,01/08/2022,15.4,7077,3593,3484,1748,893,855
127,2,36883000,3,50262,2,23923688,01/08/2022,15.7,53362,27304,26058,15169,7515,7654
128,1,16719000,3,20805,1,10846545,01/08/2022,6.2,24612,12254,12358,7339,3541,3798
129,2,48678000,1,172788,2,31467912,01/08/2022,18.8,10873,5623,5250,3757,1878,1879
130,2,59767000,2,56525,2,38792025,01/08/2022,14.8,23219,12339,10880,6425,3186,3239
131,1,26701000,3,36377,1,17319273,01/08/2022,17,12671,6512,6159,3454,1710,1744
132,1,20849000,3,31617,1,13520233,01/08/2022,15.2,30967,16277,14690,10756,5327,5429
133,2,40061000,2,54811,2,25984839,01/08/2022,17.7,323545,166328,157217,93932,46757,47175
134,1,7124000,3,19141,1,4611459,01/08/2022,22.7,19326,10155,9171,6252,3129,3123
135,1,22231000,3,36000,1,14414150,01/08/2022,9.7,33716,17686,16030,9317,4624,4693
136,1,13081000,3,48637,1,8454013,01/08/2022,17.4,40279,20716,19563,10282,5078,5204
137,1,4224000,3,21514,1,2724086,01/08/2022,17.9,29068,14916,14152,8580,4220,4360
138,1,28596000,2,57731,1,18529669,01/08/2022,18.4,12752,6694,6058,3471,1768,1703
139,1,4795000,3,48015,1,3068735,01/08/2022,15.5,33166,16973,16193,9497,4707,4790
140,1,7023000,3,13224,1,4551726,01/08/2022,17.2,52828,27143,25685,16500,8128,8372
141,2,31485000,3,25449,2,20439801,01/08/2022,16,32738,16941,15797,9059,4431,4628
142,1,9287000,3,24853,1,6011697,01/08/2022,17.9,30203,15792,14411,7568,3777,3791
143,2,31148000,3,36523,2,20209677,01/08/2022,17.2,11760,6069,5691,3432,1700,1732
144,1,9576000,3,19358,1,6205042,01/08/2022,19.5,72525,37076,35449,22128,10944,11184
145,1,8829000,3,26771,1,5712079,01/08/2022,7.3,18580,9729,8851,5724,2801,2923
146,1,19051000,3,28522,1,12354628,01/08/2022,18,24575,12798,11777,7126,3453,3673
147,1,1470000,3,20475,1,935025,01/08/2022,17.8,44731,22925,21806,13335,6514,6821
148,1,8554000,2,52752,1,5507348,01/08/2022,16.4,658907,338453,320454,150053,73914,76139
149,1,14783000,3,28130,1,9580820,01/08/2022,18.5,10336,5387,4949,3449,1664,1785
150,1,11970000,3,21170,1,7759330,01/08/2022,14.6,4656,2421,2235,1533,751,782
151,1,7344000,3,27659,1,4745941,01/08/2022,17.7,9598,5002,4596,2910,1467,1443
152,1,10737000,3,18165,1,6960885,01/08/2022,17.2,15171,7853,7318,4470,2251,2219
153,1,6414000,3,22837,1,4146263,01/08/2022,17.9,10792,5577,5215,3492,1713,1779
154,1,1996000,3,4006,1,1293394,01/08/2022,17.2,37442,19141,18301,12089,5963,6126
155,1,3769000,3,26180,1,2423670,01/08/2022,9.7,17736,9182,8554,5577,2775,2802
156,1,9024000,3,11341,1,5854259,01/08/2022,18,386290,199249,187041,112223,55337,56886
157,1,9714000,3,28260,1,6285840,01/08/2022,18,9925,5218,4707,2833,1403,1430
158,1,9021000,3,25700,1,5837950,01/08/2022,20.5,6944,3666,3278,2341,1149,1192
159,1,6915000,3,28375,1,4466375,01/08/2022,15.9,88734,45471,43263,28316,14166,14150
160,1,8001000,3,22665,1,5177985,01/08/2022,9.7,6449,3346,3103,1687,833,854
161,1,6550000,3,22368,1,4235132,01/08/2022,15.8,10735,5576,5159,3010,1518,1492
162,1,2983000,3,21579,1,1917371,01/08/2022,9.7,10810,5614,5196,2941,1451,1490
163,1,1625000,3,956,1,1055294,01/08/2022,28.9,13038,6614,6424,4157,2015,2142
165,3,178164000,1,241656,3,115564944,01/08/2022,22.1,1579803,804212,775591,594938,292494,302444
166,2,81210000,2,67655,2,52718845,01/08/2022,19.9,378143,194849,183294,128863,62806,66057
167,2,75045000,2,68963,2,48710287,01/08/2022,22.6,452090,230346,221744,162764,80177,82587
168,1,24017000,3,33752,1,15577298,01/08/2022,22.4,69371,35473,33898,25304,12303,13001
169,2,32665000,3,48278,2,21183972,01/08/2022,21,79772,40908,38864,30907,15312,15595
170,1,24200000,3,37034,1,15692966,01/08/2022,20.7,56597,29703,26894,19146,9514,9632
171,1,23480000,3,31915,1,15230085,01/08/2022,20.5,72663,38036,34627,27395,13712,13683
172,2,47763000,2,82864,2,30963086,01/08/2022,21.9,160682,83178,77504,52342,25860,26482
173,2,29987000,3,35850,2,19455700,01/08/2022,21.1,83352,42766,40586,32937,16375,16562
174,2,30109000,3,32495,2,19538355,01/08/2022,19.9,67101,35567,31534,27008,13393,13615
175,1,17563000,3,35341,1,11380609,01/08/2022,20.5,43249,22352,20897,17065,8284,8781
176,1,25583000,3,39865,1,16589085,01/08/2022,20.6,51894,27702,24192,20579,10113,10466
177,1,24303000,3,49198,1,15747752,01/08/2022,21.6,70068,36526,33542,21044,10402,10642
178,1,19979000,3,25558,1,12960792,01/08/2022,21.4,52156,27081,25075,17108,8394,8714
179,1,4329000,3,25203,1,2788647,01/08/2022,20.8,41910,21741,20169,12631,6146,6485
180,1,23407000,3,48947,1,15165603,01/08/2022,20.9,43998,23109,20889,17575,8775,8800
181,1,5270000,3,24859,1,3400641,01/08/2022,23.5,24757,12827,11930,9816,4898,4918
182,1,4408000,3,24797,1,2840403,01/08/2022,20.1,21756,11234,10522,8659,4317,4342
183,1,8150000,3,15100,1,5282400,01/08/2022,20.9,28109,14419,13690,10548,5187,5361
184,1,6017000,3,23089,1,3887961,01/08/2022,22.7,15305,7996,7309,5899,2872,3027
185,1,26881000,3,39161,1,17433489,01/08/2022,20.3,72452,38019,34433,23628,11618,12010
186,1,15845000,3,24706,1,10274544,01/08/2022,21,35401,18444,16957,12235,5945,6290
187,1,23366000,3,36305,1,15151595,01/08/2022,19.9,27593,14289,13304,10803,5260,5543
188,1,19338000,3,23089,1,12546611,01/08/2022,22,31264,16171,15093,9806,4840,4966
189,1,18020000,3,38451,1,11674549,01/08/2022,17.8,24228,12861,11367,9383,4674,4709
190,1,18201000,3,24761,1,11805889,01/08/2022,17.9,32831,17049,15782,13856,6706,7150
191,1,2844000,3,23385,1,1825215,01/08/2022,21.8,16092,8507,7585,6837,3451,3386
192,1,7072000,3,27056,1,4569744,01/08/2022,19.2,8011,4268,3743,3134,1562,1572
193,1,14318000,3,26453,1,9280247,01/08/2022,22.5,29002,14796,14206,11206,5550,5656
194,1,3292000,3,26194,1,2113606,01/08/2022,18.9,7946,4172,3774,3293,1607,1686
195,1,11043000,3,9761,1,7168189,01/08/2022,21.9,28260,14728,13532,11002,5473,5529
196,1,5588000,3,6425,1,3625775,01/08/2022,20.1,25845,13471,12374,9370,4627,4743
197,3,142973000,1,186060,3,92746390,01/08/2022,28.9,658609,345979,312630,183298,90145,93153
198,2,58134000,2,57387,2,37729713,01/08/2022,23.4,225728,119129,106599,71494,35347,36147
199,2,35801000,3,44531,2,23226119,01/08/2022,31.9,70760,36613,34147,21788,10705,11083
200,2,44486000,2,79406,2,28836494,01/08/2022,25.8,132854,69610,63244,41183,20301,20882
201,1,17958000,2,55787,1,11616913,01/08/2022,20.1,50399,26542,23857,14000,6918,7082
202,1,3459000,3,26102,1,2222248,01/08/2022,22.8,27944,14419,13525,9490,4664,4826
203,1,6651000,3,26870,1,4296280,01/08/2022,20.5,22534,11802,10732,7926,3939,3987
204,1,14901000,3,32499,1,9653151,01/08/2022,26.6,25148,13436,11712,8928,4476,4452
205,1,26319000,3,29052,1,17078298,01/08/2022,22.5,33783,18241,15542,12201,6089,6112
206,2,33467000,3,27607,2,21725943,01/08/2022,26.8,25850,13268,12582,8390,4048,4342
208,2,37408000,3,37914,2,24277286,01/08/2022,20.2,27607,14605,13002,9883,5002,4881
209,1,9222000,3,26797,1,5967503,01/08/2022,27.5,13866,7187,6679,4383,2099,2284
210,1,7468000,3,26453,1,4827747,01/08/2022,27.1,23363,12127,11236,7776,3818,3958
211,1,15959000,3,30037,1,10343313,01/08/2022,25,18224,9500,8724,7072,3514,3558
212,1,14275000,3,26200,1,9252550,01/08/2022,28.9,16447,8464,7983,4843,2381,2462
213,1,6059000,3,14021,1,3924329,01/08/2022,24,17550,9283,8267,5700,2861,2839
214,2,69488000,1,155849,2,45011351,01/08/2022,18.2,297848,156299,141549,74787,37046,37741
215,1,28333000,3,22157,1,18394293,01/08/2022,21.1,29390,15521,13869,7939,3942,3997
216,2,36211000,2,65746,2,23471404,01/08/2022,21,37608,20094,17514,11115,5490,5625
217,2,40214000,2,73293,2,26065807,01/08/2022,18.6,106163,56161,50002,30752,15034,15718
218,1,14689000,3,24730,1,9523120,01/08/2022,17,11149,5894,5255,2996,1479,1517
219,2,38385000,2,52935,2,24897315,01/08/2022,15.6,60265,30945,29320,18808,9224,9584
220,1,21330000,3,31176,1,13833324,01/08/2022,20.9,17718,9411,8307,4913,2492,2421
221,1,18115000,3,32009,1,11742741,01/08/2022,19.3,36618,19077,17541,10530,5273,5257
222,1,13385000,3,24416,1,8675834,01/08/2022,20.7,9853,5224,4629,2757,1390,1367
223,1,2952000,3,25913,1,1892887,01/08/2022,19.8,27713,14561,13152,7736,3885,3851
224,1,7776000,3,22279,1,5032121,01/08/2022,19.2,32276,17014,15262,9457,4578,4879
225,1,8486000,3,23027,1,5492873,01/08/2022,20.7,14689,7582,7107,4123,2033,2090
226,2,45352000,3,46489,2,29432311,01/08/2022,30.6,44311,23331,20980,13756,6771,6985
227,1,4748000,3,24812,1,3061388,01/08/2022,22.3,14732,7791,6941,4911,2433,2478
228,1,12170000,3,24788,1,7885712,01/08/2022,18.4,20530,10890,9640,6356,3180,3176
229,1,12928000,3,22745,1,8380455,01/08/2022,27.7,16368,8558,7810,4728,2323,2405
230,1,9217000,3,24709,1,5966341,01/08/2022,15.1,6213,3216,2997,1786,871,915
231,1,11210000,3,22331,1,7264169,01/08/2022,15.6,28792,15288,13504,8327,4111,4216
233,1,5286000,3,6731,1,3429169,01/08/2022,20.5,8657,4501,4156,2464,1200,1264
234,2,76055000,1,107513,2,49328237,01/08/2022,27.8,224166,112147,112019,65088,31954,33134
235,2,31498000,2,70119,2,20403581,01/08/2022,20.7,111569,57370,54199,36412,17892,18520
236,1,27771000,3,33735,1,18017415,01/08/2022,21.9,38780,20122,18658,13025,6461,6564
237,3,167027000,1,326047,3,108241503,01/08/2022,20.3,1385621,718628,666993,333198,164217,168981
238,3,112479000,1,249910,3,72861440,01/08/2022,21.1,1257547,645398,612149,321993,158559,163434
239,1,21472000,3,29868,1,13926932,01/08/2022,23.5,37871,19554,18317,11359,5732,5627
240,2,92984000,1,199120,2,60240480,01/08/2022,23.5,650123,329365,320758,200033,98558,101475
241,2,43461000,2,69322,2,28180328,01/08/2022,22.8,111975,57735,54240,31481,15460,16021
242,1,15254000,3,24817,1,9890283,01/08/2022,21.9,98842,50427,48415,30938,15263,15675
243,2,68270000,1,184144,2,44191356,01/08/2022,21.9,44103,22420,21683,15768,7755,8013
244,1,11764000,3,26381,1,7620219,01/08/2022,21.3,53539,27205,26334,18000,8916,9084
245,1,12012000,3,26326,1,7781474,01/08/2022,28.7,18787,9476,9311,6502,3270,3232
246,1,17608000,3,35435,1,11409765,01/08/2022,21.9,59648,30609,29039,19344,9536,9808
247,2,61595000,2,101824,2,39934926,01/08/2022,22.8,30471,15635,14836,9610,4654,4956
248,1,5000000,3,25887,1,3224113,01/08/2022,22.5,20286,10307,9979,6804,3413,3391
249,1,4782000,3,22997,1,3085303,01/08/2022,22.5,20345,10131,10214,6733,3300,3433
250,1,21339000,3,38524,1,13831826,01/08/2022,22.2,31115,15891,15224,10525,5240,5285
251,1,13849000,3,44166,1,8957684,01/08/2022,22.5,16550,8456,8094,5252,2552,2700
252,1,18161000,3,25462,1,11779188,01/08/2022,22.3,24352,12627,11725,8092,4062,4030
253,1,18679000,3,45710,1,12095640,01/08/2022,20.5,94978,48709,46269,29794,14672,15122
254,1,22017000,3,28314,1,14282736,01/08/2022,26.2,52019,26739,25280,15725,7759,7966
255,1,4160000,3,23616,1,2680384,01/08/2022,22.1,24580,12765,11815,8215,4057,4158
256,1,13869000,3,24830,1,8990020,01/08/2022,24.7,28678,14679,13999,9074,4497,4577
257,1,5124000,3,23614,1,3306986,01/08/2022,15.9,22738,11719,11019,7000,3537,3463
258,1,11779000,3,23930,1,7632420,01/08/2022,22.8,28145,14670,13475,8863,4390,4473
259,1,9371000,3,27996,1,6063154,01/08/2022,22.8,19113,9852,9261,5504,2716,2788
260,1,2284000,3,23385,1,1461215,01/08/2022,21.3,25925,13382,12543,8585,4189,4396
261,1,1139000,3,23385,1,716965,01/08/2022,24.7,13033,6697,6336,4420,2181,2239
262,1,3069000,3,23548,1,1971302,01/08/2022,10.3,5955,3118,2837,1972,974,998
263,1,1889000,3,20131,1,1207719,01/08/2022,22.2,8850,4524,4326,2773,1377,1396
264,1,2857000,3,21798,1,1835252,01/08/2022,15.9,9529,4943,4586,3018,1490,1528
265,1,10142000,3,27607,1,6564693,01/08/2022,21.3,14636,7533,7103,4910,2424,2486
266,1,18792000,3,38741,1,12176059,01/08/2022,22.5,40906,20800,20106,12864,6409,6455
267,1,6650000,3,25718,1,4296782,01/08/2022,22.8,8142,4289,3853,2686,1333,1353
268,1,2566000,3,22997,1,1644903,01/08/2022,15.9,7954,4060,3894,2570,1274,1296
269,1,11592000,3,25093,1,7509707,01/08/2022,22.2,17000,8527,8473,5215,2549,2666
270,1,4011000,3,23041,1,2584109,01/08/2022,21.2,14424,7439,6985,5399,2678,2721
271,1,2602000,3,23509,1,1667791,01/08/2022,22.2,16873,8725,8148,6022,3008,3014
272,1,3173000,3,18902,1,2043548,01/08/2022,22.8,5109,2618,2491,1631,805,826
273,1,2517000,3,23829,1,1612221,01/08/2022,22.8,13243,6795,6448,4043,1954,2089
274,1,2736000,3,22279,1,1756121,01/08/2022,21.3,14497,7627,6870,4260,2099,2161
275,1,2781000,3,20273,1,1787377,01/08/2022,22.3,16324,8373,7951,5562,2774,2788
276,1,5976000,3,24254,1,3860146,01/08/2022,28.1,9842,5047,4795,3323,1629,1694
277,1,3302000,3,22838,1,2123462,01/08/2022,21.3,27833,14525,13308,9097,4581,4516
278,1,4784000,3,6228,1,3103372,01/08/2022,22.3,33284,17172,16112,10804,5349,5455
279,1,2328000,3,22563,1,1490637,01/08/2022,24.2,14697,7601,7096,4740,2380,2360
280,1,3859000,3,20435,1,2487915,01/08/2022,20.5,18607,9363,9244,6403,3178,3225
284,3,109674000,1,166011,3,71122089,01/08/2022,19.3,743275,388114,355161,202467,99875,102592
285,2,41654000,2,91959,2,26983141,01/08/2022,19.7,154546,80401,74145,48513,24003,24510
286,2,72494000,1,110265,2,47010835,01/08/2022,19.4,299523,155411,144112,93845,46362,47483
287,2,49059000,2,63521,2,31824829,01/08/2022,29,83637,42325,41312,24783,12286,12497
288,2,36501000,2,70691,2,23654959,01/08/2022,28.9,102362,52461,49901,35162,17416,17746
289,1,17449000,3,34201,1,11307649,01/08/2022,21.5,55287,28877,26410,16959,8447,8512
290,1,24042000,3,40763,1,15586537,01/08/2022,23.3,87042,45232,41810,26414,12958,13456
291,2,38934000,2,63149,2,25243951,01/08/2022,12.2,86901,45620,41281,26262,13160,13102
292,1,21721000,3,24028,1,14094622,01/08/2022,20.6,30519,15931,14588,10809,5325,5484
293,2,31849000,3,36159,2,20665691,01/08/2022,19.1,60811,31893,28918,19713,9706,10007
294,1,4010000,3,10338,1,2596162,01/08/2022,17.6,61510,31765,29745,21000,10487,10513
295,1,22842000,2,63389,1,14783911,01/08/2022,19.5,70042,36241,33801,21818,10809,11009
296,1,4841000,3,10453,1,3136197,01/08/2022,21.1,24662,12965,11697,6937,3350,3587
297,1,5942000,3,20964,1,3841336,01/08/2022,17.6,15414,7999,7415,4635,2291,2344
298,1,23842000,3,24776,1,15472524,01/08/2022,18.3,71528,37497,34031,23278,11539,11739
299,1,1935000,3,24422,1,1233328,01/08/2022,20.6,15249,7932,7317,4894,2453,2441
300,1,28910000,3,25234,1,18766266,01/08/2022,19.4,39425,20578,18847,13203,6477,6726
301,1,3646000,3,25643,1,2344257,01/08/2022,21.1,17293,8766,8527,5650,2795,2855
302,1,12288000,3,25462,1,7961738,01/08/2022,12.2,16905,8772,8133,5514,2740,2774
303,1,4197000,3,23270,1,2704780,01/08/2022,19.1,18097,9360,8737,5881,2892,2989
304,1,13220000,3,25234,1,8567766,01/08/2022,21.2,32333,16690,15643,10314,5057,5257
305,1,19107000,3,26797,1,12392753,01/08/2022,19.9,49940,25545,24395,16071,7998,8073
306,1,17731000,3,26984,1,11498166,01/08/2022,19.7,1049,546,503,282,149,133
307,1,14167000,3,28750,1,9179800,01/08/2022,19.6,6853,3584,3269,2311,1149,1162
308,1,7140000,3,6025,1,4634975,01/08/2022,27.9,12262,6119,6143,4251,2104,2147
309,1,2652000,3,30198,1,1693602,01/08/2022,19.9,11086,5609,5477,3615,1780,1835
310,1,2625000,3,27565,1,1678685,01/08/2022,23.3,13821,7083,6738,3938,1966,1972
311,2,53917000,1,148798,2,34897252,01/08/2022,22,341029,180370,160659,82444,40670,41774
312,2,75188000,1,106588,2,48765612,01/08/2022,23.2,157336,82380,74956,43883,21497,22386
313,1,23530000,3,16803,1,15277697,01/08/2022,26.6,174629,91268,83361,46521,22880,23641
314,2,33238000,2,56299,2,21548401,01/08/2022,25.1,104461,54150,50311,30967,15315,15652
315,1,17288000,3,49780,1,11187420,01/08/2022,24,44353,23038,21315,13070,6400,6670
316,1,5669000,3,25987,1,3658863,01/08/2022,25.9,21375,11206,10169,5662,2753,2909
317,2,32653000,3,48131,2,21176319,01/08/2022,26.3,17777,9225,8552,4254,2086,2168
318,2,39466000,2,92365,2,25560535,01/08/2022,26.6,64084,32934,31150,19785,9668,10117
319,1,15806000,3,27074,1,10246826,01/08/2022,26.3,20434,10867,9567,5939,2970,2969
320,1,15263000,3,27250,1,9893700,01/08/2022,17.6,19085,9763,9322,6343,3119,3224
321,3,105849000,1,121825,3,68680025,01/08/2022,24.3,371387,192530,178857,106784,52432,54352
322,1,20418000,3,21195,1,13250505,01/08/2022,28.3,18023,9240,8783,5154,2503,2651
323,1,14022000,3,44925,1,9069375,01/08/2022,24.2,20322,10479,9843,6201,3025,3176
324,1,21255000,3,31705,1,13784045,01/08/2022,24.2,25477,13300,12177,8208,4059,4149
325,1,8983000,3,50739,1,5788211,01/08/2022,28.4,13620,7015,6605,4098,1994,2104
326,1,10959000,3,24031,1,7099319,01/08/2022,24.2,48170,25016,23154,15515,7657,7858
327,1,9419000,3,49739,1,6072611,01/08/2022,30,10593,5340,5253,3485,1705,1780
328,2,40069000,2,77495,2,25967355,01/08/2022,28.3,8730,4395,4335,2894,1447,1447
329,1,4737000,3,23614,1,3055436,01/08/2022,28.6,14678,7367,7311,4863,2405,2458
330,1,8234000,3,24036,1,5328064,01/08/2022,28.3,10935,5450,5485,3532,1706,1826
331,1,11209000,3,23415,1,7262435,01/08/2022,29.5,19976,10345,9631,6431,3120,3311
332,2,62712000,1,108482,2,40654318,01/08/2022,30.8,412199,209241,202958,82879,40585,42294
333,2,60742000,1,121475,2,39360825,01/08/2022,30.8,304052,152635,151417,84118,41457,42661
334,2,91593000,1,137288,2,59398162,01/08/2022,28.9,536436,267279,269157,158598,77797,80801
335,3,122946000,1,141796,3,79773104,01/08/2022,28.9,635862,320627,315235,153834,75737,78097
336,3,153323000,1,207314,3,99452636,01/08/2022,31,1142952,578172,564780,270109,132170,137939
338,1,16833000,3,32578,1,10908872,01/08/2022,28.9,75721,38037,37684,21903,10795,11108
339,1,20812000,3,34345,1,13493455,01/08/2022,32.6,70378,35870,34508,21367,10464,10903
340,2,44484000,3,24784,2,28889816,01/08/2022,19.2,308285,152976,155309,108145,53196,54949
342,2,42376000,2,62388,2,27482012,01/08/2022,27.1,234698,115478,119220,87040,43098,43942
343,1,13262000,3,27271,1,8593029,01/08/2022,28.9,28843,14318,14525,8529,4190,4339
344,1,12984000,3,24890,1,8414710,01/08/2022,29.7,33522,17126,16396,9330,4711,4619
345,1,17152000,3,48282,1,11100518,01/08/2022,30.5,54467,27606,26861,15858,7789,8069
346,1,15742000,3,20875,1,10211425,01/08/2022,30.8,13059,6525,6534,4137,2073,2064
347,1,1518000,3,4437,1,982263,01/08/2022,19.2,9934,4952,4982,3082,1558,1524
348,1,5571000,3,24794,1,3596356,01/08/2022,19.2,7844,4131,3713,2621,1355,1266
349,1,9401000,3,49603,1,6061047,01/08/2022,28.9,48069,23121,24948,16392,8040,8352
350,1,10845000,3,27591,1,7021659,01/08/2022,30.8,11583,5810,5773,3713,1872,1841
351,1,4713000,3,21066,1,3042384,01/08/2022,27.3,29903,15539,14364,9778,4798,4980
352,3,150584000,1,251103,3,97628497,01/08/2022,24.2,258913,138803,120110,68042,33683,34359
353,2,53612000,2,83853,2,34763947,01/08/2022,28.1,103609,54904,48705,31555,15575,15980
354,2,30474000,2,73218,2,19734882,01/08/2022,29.8,76660,40113,36547,21596,10646,10950
355,2,39711000,3,49655,2,25762495,01/08/2022,30,88280,46038,42242,25864,12608,13256
356,2,30062000,2,57854,2,19482446,01/08/2022,22.6,56163,29689,26474,18214,8872,9342
357,1,2730000,3,29808,1,1744692,01/08/2022,28.1,7263,3837,3426,2540,1279,1261
358,1,16911000,3,23982,1,10968168,01/08/2022,28.9,16645,8759,7886,5075,2484,2591
359,1,14718000,3,51406,1,9515294,01/08/2022,26.9,31469,16729,14740,9837,4899,4938
360,1,14682000,3,24045,1,9519255,01/08/2022,17.5,12729,6935,5794,4541,2296,2245
361,1,13274000,3,26723,1,8601377,01/08/2022,30,26015,13735,12280,7360,3633,3727
362,2,41802000,3,29962,2,27141338,01/08/2022,27.3,29903,15539,14364,9778,4798,4980
363,1,26200000,3,37093,1,16992907,01/08/2022,27.7,10504,5405,5099,3440,1722,1718
364,1,18933000,3,25346,1,12281104,01/08/2022,30.3,45134,23442,21692,13494,6690,6804
365,1,23370000,3,39323,1,15151177,01/08/2022,21.1,29130,15431,13699,9957,5019,4938
366,1,5558000,3,19836,1,3592864,01/08/2022,28,5812,3105,2707,1767,906,861
367,1,14404000,3,29360,1,9333240,01/08/2022,17.5,15851,8463,7388,5625,2839,2786
368,1,5686000,3,23514,1,3672386,01/08/2022,21.1,15298,8185,7113,4499,2268,2231
369,2,29233000,3,29671,2,18971779,01/08/2022,30,17525,9370,8155,5075,2488,2587
370,1,21337000,2,71484,1,13797566,01/08/2022,17.5,18915,10248,8667,6395,3217,3178
371,1,22619000,3,21827,1,14680523,01/08/2022,21.4,81848,43535,38313,23849,11894,11955
372,2,40050000,3,40142,2,25992358,01/08/2022,21.2,33726,17513,16213,11096,5372,5724
373,1,2597000,3,35027,1,1653023,01/08/2022,21.1,11168,5931,5237,3889,1954,1935
374,1,5408000,3,25315,1,3489885,01/08/2022,28.1,6341,3343,2998,2049,979,1070
375,1,22680000,3,20065,1,14721935,01/08/2022,21.4,45895,23816,22079,12162,5997,6165
376,1,6506000,3,39328,1,4189572,01/08/2022,26.4,6863,3664,3199,2612,1321,1291
377,1,10285000,3,25364,1,6659886,01/08/2022,21.2,10611,5602,5009,3876,1871,2005
378,1,3831000,3,25414,1,2464736,01/08/2022,28.9,14226,7514,6712,4380,2214,2166
379,1,5173000,3,25033,1,3337417,01/08/2022,21.4,7997,4114,3883,2359,1161,1198
380,1,4032000,3,11093,1,2609707,01/08/2022,26.9,4188,2243,1945,1509,761,748
381,2,31308000,2,56577,2,20293623,01/08/2022,27.3,15373,8115,7258,5203,2638,2565
382,1,18409000,3,22619,1,11943231,01/08/2022,29.1,14071,7408,6663,4497,2251,2246
383,1,2280000,3,20585,1,1461415,01/08/2022,15.8,6642,3720,2922,2058,1005,1053
384,1,5999000,3,6510,1,3892840,01/08/2022,27.2,11054,5638,5416,3563,1745,1818
385,3,226055000,1,415595,3,146520155,01/08/2022,19,1542232,806262,735970,402209,198130,204079
386,2,48163000,2,61872,2,31244078,01/08/2022,17.5,78264,40929,37335,23163,11368,11795
387,2,65104000,2,102194,2,42215406,01/08/2022,21.1,293825,155300,138525,93203,46206,46997
388,1,28492000,2,53914,1,18465886,01/08/2022,28.8,49578,26095,23483,16381,8171,8210
389,2,38029000,3,39454,2,24679396,01/08/2022,20,89314,47398,41916,25892,12760,13132
390,2,46336000,3,35214,2,30083186,01/08/2022,19.6,31315,16320,14995,10348,5100,5248
391,1,19260000,3,49260,1,12469740,01/08/2022,15.3,39203,20881,18322,12964,6446,6518
392,1,21595000,3,49500,1,13987250,01/08/2022,20.4,58957,31503,27454,19229,9506,9723
393,2,35937000,2,83859,2,23275191,01/08/2022,17.4,62849,33939,28910,17954,8876,9078
394,1,19875000,3,36225,1,12882525,01/08/2022,16.1,25468,13582,11886,8293,4136,4157
395,1,22568000,3,45881,1,14623319,01/08/2022,15.3,31599,16595,15004,11708,5967,5741
396,2,30458000,3,51150,2,19746550,01/08/2022,15.3,29123,15247,13876,9589,4733,4856
397,1,15992000,3,27435,1,10367365,01/08/2022,19.6,18110,9443,8667,6325,3046,3279
398,1,11880000,3,46945,1,7675055,01/08/2022,15.3,31695,16422,15273,11280,5582,5698
399,1,16654000,3,33815,1,10791285,01/08/2022,15.3,95322,48884,46438,32521,16133,16388
400,1,15829000,3,29090,1,10259760,01/08/2022,15.3,9358,5013,4345,2738,1323,1415
401,1,12227000,3,48336,1,7899214,01/08/2022,15.9,9149,4948,4201,2691,1357,1334
402,1,3621000,3,23385,1,2330265,01/08/2022,15.3,9913,5282,4631,3496,1711,1785
403,1,11353000,3,9595,1,7369855,01/08/2022,15.3,36620,18819,17801,10303,4961,5342
404,1,1870000,3,24034,1,1191466,01/08/2022,15.3,5276,2719,2557,1830,893,937
405,1,18940000,3,26797,1,12284203,01/08/2022,15.3,41455,21994,19461,13993,6843,7150
406,1,16204000,3,23692,1,10508908,01/08/2022,18.4,29613,15403,14210,9414,4672,4742
408,1,11250000,3,23088,1,7289412,01/08/2022,17.1,13922,7166,6756,5211,2590,2621
409,1,3373000,3,21797,1,2170653,01/08/2022,15.3,10960,5789,5171,3556,1785,1771
410,1,12588000,3,26797,1,8155403,01/08/2022,13.1,22904,12086,10818,7644,3743,3901
411,1,7550000,3,23692,1,4883808,01/08/2022,15.3,11776,6077,5699,3730,1832,1898
412,1,1653000,3,8759,1,1065691,01/08/2022,15.3,16797,8560,8237,5425,2652,2773
413,1,3564000,3,23385,1,2293215,01/08/2022,15.3,19648,10052,9596,6751,3334,3417
414,1,15718000,3,27737,1,10188963,01/08/2022,25.8,19341,10302,9039,6428,3158,3270
415,1,3051000,3,26568,1,1956582,01/08/2022,15.9,11487,6208,5279,3749,1855,1894
416,1,6093000,3,18296,1,3942154,01/08/2022,15.3,5703,2985,2718,1959,971,988
417,1,1716000,3,19989,1,1095411,01/08/2022,15.3,6644,3435,3209,2305,1130,1175
418,1,3456000,3,19553,1,2226847,01/08/2022,15.3,7491,3982,3509,2583,1266,1317
419,1,2141000,3,14051,1,1377599,01/08/2022,15.3,8481,4360,4121,2849,1391,1458
420,1,23870000,3,36102,1,15479398,01/08/2022,18.1,46996,24240,22756,12187,6012,6175
421,1,2821000,3,20587,1,1813063,01/08/2022,21.4,8445,4468,3977,3005,1505,1500
422,1,6160000,3,21749,1,3982251,01/08/2022,18,5612,3027,2585,1851,938,913
423,1,6715000,3,25040,1,4339710,01/08/2022,26.1,5276,2719,2557,1830,893,937
424,3,183645000,1,242417,3,119126833,01/08/2022,21,794789,407239,387550,199480,98049,101431
425,2,45585000,2,61884,2,29568366,01/08/2022,17.9,177719,91525,86194,50219,24680,25539
426,1,18697000,3,26321,1,12126729,01/08/2022,17.9,34955,18206,16749,9854,4805,5049
427,1,2253000,3,21705,1,1442745,01/08/2022,17.9,115264,60166,55098,28758,14392,14366
428,1,14973000,3,24080,1,9708370,01/08/2022,17.9,16795,8697,8098,5436,2628,2808
429,1,7184000,3,23270,1,4646330,01/08/2022,21.7,13390,6831,6559,4033,1966,2067
430,1,8256000,3,24328,1,5342072,01/08/2022,21.7,7953,4224,3729,2375,1195,1180
431,1,7829000,3,19231,1,5069619,01/08/2022,27.6,15512,8121,7391,5093,2493,2600
432,2,59533000,3,47451,2,38648999,01/08/2022,29.1,169028,86790,82238,45879,22689,23190
433,3,162282000,1,153625,3,105329675,01/08/2022,30,888797,441181,447616,247410,121384,126026
434,2,74228000,2,73288,2,48174912,01/08/2022,27.8,304942,149380,155562,85665,42398,43267
435,2,29146000,2,62877,2,18882023,01/08/2022,28.4,84519,42292,42227,24955,12440,12515
436,1,16642000,3,22745,1,10794555,01/08/2022,28.1,30754,15948,14806,10320,5221,5099
437,3,139906000,1,133525,3,90805375,01/08/2022,21.6,845941,437370,408571,227808,112567,115241
438,2,61034000,2,62324,2,39609776,01/08/2022,31.1,136351,71718,64633,38918,19062,19856
439,1,28874000,3,51548,1,18716552,01/08/2022,23.6,86686,44901,41785,27406,13467,13939
440,2,29178000,3,46522,2,18919178,01/08/2022,27.2,58158,30570,27588,17715,8934,8781
441,1,27134000,2,66669,1,17570431,01/08/2022,30.5,24258,12834,11424,7258,3602,3656
442,1,12827000,3,27607,1,8309943,01/08/2022,30.4,24454,12691,11763,7326,3576,3750
443,1,22478000,3,28880,1,14581820,01/08/2022,20.8,310192,159130,151062,94872,46787,48085
444,1,3358000,3,30604,1,2152096,01/08/2022,21.9,14340,7646,6694,4731,2430,2301
445,2,61674000,2,73047,2,40015053,01/08/2022,30.4,15341,8078,7263,4842,2416,2426
446,1,5119000,3,25767,1,3301583,01/08/2022,30.5,8045,4283,3762,2501,1247,1254
447,1,10641000,3,24838,1,6891812,01/08/2022,30.5,6644,3540,3104,2086,1058,1028
448,1,4063000,3,21846,1,2619104,01/08/2022,30.4,16582,8647,7935,5030,2477,2553
449,1,25529000,2,80867,1,16512983,01/08/2022,30.4,30796,15740,15056,9239,4503,4736
450,2,64643000,2,82477,2,41935473,01/08/2022,29.8,77849,40866,36983,21990,10871,11119
451,2,34847000,3,44014,2,22606536,01/08/2022,29.4,65215,33971,31244,19700,9733,9967
452,3,125544000,1,142762,3,81460838,01/08/2022,28,441975,227109,214866,122010,60145,61865
453,3,271548000,1,254707,3,176251493,01/08/2022,31.3,808416,416251,392165,234633,115277,119356
454,2,84481000,1,133690,2,54778960,01/08/2022,31.1,298009,154344,143665,83869,41238,42631
455,1,16724000,3,22059,1,10848541,01/08/2022,30.3,33924,17240,16684,10629,5267,5362
456,1,12046000,3,29978,1,7799922,01/08/2022,29,14772,7516,7256,4444,2199,2245
457,1,18488000,3,31749,1,11985451,01/08/2022,29.3,19742,9908,9834,6831,3367,3464
458,1,11482000,3,29812,1,7433488,01/08/2022,30.9,12848,6693,6155,3711,1831,1880
459,1,10233000,3,25030,1,6626420,01/08/2022,28.2,5457,2839,2618,1473,755,718
460,1,5999000,3,26275,1,3873075,01/08/2022,28.7,5926,3043,2883,1700,842,858
461,1,11821000,3,25928,1,7657722,01/08/2022,30.3,17097,8801,8296,5359,2662,2697
462,1,11849000,3,50797,1,7651053,01/08/2022,30.4,28239,14113,14126,8795,4312,4483
463,1,11930000,3,23337,1,7731163,01/08/2022,29.2,16934,8502,8432,5395,2626,2769
464,1,13877000,3,50068,1,8969982,01/08/2022,30.1,11851,5973,5878,3739,1841,1898
465,1,6247000,3,24652,1,4035898,01/08/2022,29.8,25157,12582,12575,8765,4230,4535
466,1,3723000,3,22370,1,2397580,01/08/2022,29,6055,3107,2948,1652,803,849
467,1,3156000,3,23729,1,2027671,01/08/2022,29.8,22421,11364,11057,6263,3134,3129
468,1,2248000,3,23614,1,1437586,01/08/2022,29.2,9864,5093,4771,3123,1529,1594
469,1,3237000,3,19196,1,2084854,01/08/2022,28.8,7888,4037,3851,3058,1509,1549
470,1,5094000,3,25913,1,3285187,01/08/2022,28.2,5524,2885,2639,1817,894,923
472,1,3065000,3,35966,1,1956284,01/08/2022,29.9,10328,5288,5040,3690,1794,1896
473,1,1042000,3,4037,1,673263,01/08/2022,28.8,4810,2229,2581,1556,759,797
474,2,85193000,1,139638,2,55235812,01/08/2022,30,329404,168547,160857,90108,44605,45503
475,3,162711000,1,260062,3,105502088,01/08/2022,30.4,855563,431621,423942,240318,117646,122672
476,2,32586000,2,77270,2,21103630,01/08/2022,30.3,117253,59414,57839,33098,16300,16798
477,2,61785000,2,59566,2,40100684,01/08/2022,35.8,176685,87738,88947,53884,26504,27380
478,2,69534000,1,121774,2,45075326,01/08/2022,25.6,261137,131158,129979,84004,41439,42565
479,2,38302000,3,50302,2,24845998,01/08/2022,30.8,120926,61958,58968,34805,17098,17707
480,1,25473000,3,34097,1,16523353,01/08/2022,32.7,67604,34141,33463,21101,10330,10771
481,1,12191000,3,22745,1,7901405,01/08/2022,30.7,38886,19733,19153,11641,5731,5910
482,1,15637000,3,25360,1,10138690,01/08/2022,29.6,30324,15540,14784,8298,4088,4210
483,1,27441000,3,34907,1,17801743,01/08/2022,25.6,91029,45722,45307,30379,15003,15376
484,1,23154000,3,29669,1,15020431,01/08/2022,33.6,62301,30877,31424,20494,10127,10367
485,1,3067000,3,22049,1,1971501,01/08/2022,26,12987,6460,6527,4296,2156,2140
486,1,14011000,3,26329,1,9080821,01/08/2022,23.7,38113,19225,18888,12385,6138,6247
487,1,2615000,3,23385,1,1676365,01/08/2022,31.4,12372,6340,6032,3845,1851,1994
488,1,11912000,3,22312,1,7720488,01/08/2022,31,39474,19169,20305,14904,7336,7568
489,1,13591000,3,26809,1,8807341,01/08/2022,28.7,30429,15578,14851,9786,4826,4960
490,1,4892000,3,26797,1,3153003,01/08/2022,30,13153,6653,6500,4059,2009,2050
491,1,4279000,3,26947,1,2754403,01/08/2022,31.6,11440,5836,5604,4121,2095,2026
492,1,2702000,3,25553,1,1730747,01/08/2022,33.5,4787,2437,2350,1357,684,673
493,3,107865000,1,161258,3,69950992,01/08/2022,27.4,340060,178122,161938,86078,42456,43622
494,2,50673000,3,39874,2,32897576,01/08/2022,28.9,43035,22773,20262,11996,6054,5942
495,1,22512000,3,35155,1,14597645,01/08/2022,29.2,27182,14325,12857,8434,4220,4214
496,1,15680000,3,25078,1,10166922,01/08/2022,28.9,21003,10909,10094,6452,3209,3243
497,1,25581000,3,36690,1,16590960,01/08/2022,29.1,31435,16316,15119,9125,4445,4680
498,1,18367000,3,41346,1,11897204,01/08/2022,28.7,29068,15153,13915,8638,4280,4358
499,1,19042000,3,23218,1,12354082,01/08/2022,29.4,25555,13197,12358,7191,3479,3712
500,1,7191000,3,11642,1,4662508,01/08/2022,28.4,13944,7272,6672,4420,2177,2243
501,1,20982000,3,22745,1,13615555,01/08/2022,28,34946,17956,16990,11208,5422,5786
502,1,13274000,3,24112,1,8603988,01/08/2022,29.2,16679,8618,8061,4633,2284,2349
503,2,70664000,2,80474,2,45851126,01/08/2022,30.2,297373,155718,141655,71865,35366,36499
504,3,163343000,1,197406,3,105975544,01/08/2022,30.6,691557,348387,343170,213267,104895,108372
505,2,83972000,2,74049,2,54507751,01/08/2022,31.4,416055,211059,204996,132268,65355,66913
506,1,21458000,3,33054,1,13914646,01/08/2022,30.9,111314,55902,55412,35576,17423,18153
507,2,71762000,2,92860,2,46552440,01/08/2022,30.5,332100,171749,160351,94911,46503,48408
508,2,34681000,3,49219,2,22493431,01/08/2022,31.1,79515,41903,37612,21445,10720,10725
509,2,35367000,2,53493,2,22935057,01/08/2022,29.7,205933,107685,98248,49242,24249,24993
510,1,15024000,3,23089,1,9742511,01/08/2022,31.3,48172,24667,23505,15031,7399,7632
511,1,9913000,3,25118,1,6418332,01/08/2022,30.9,18592,8945,9647,4116,2046,2070
512,2,33555000,3,40543,2,21770207,01/08/2022,30.4,79824,40689,39135,24808,12213,12595
513,1,2998000,3,20349,1,1928351,01/08/2022,30.9,10327,5388,4939,2996,1506,1490
514,1,8938000,3,20367,1,5789333,01/08/2022,30.9,28215,14347,13868,9384,4582,4802
515,1,5906000,3,6355,1,3832545,01/08/2022,30.4,10993,5737,5256,3544,1803,1741
517,1,28035000,3,39363,1,18183387,01/08/2022,15,53373,27810,25563,15744,7755,7989
518,2,38064000,2,74827,2,24666773,01/08/2022,18.5,13555,7357,6198,3051,1547,1504
519,1,28464000,3,37678,1,18463922,01/08/2022,15.6,59871,31271,28600,19112,9469,9643
520,2,48339000,2,72204,2,31348146,01/08/2022,17.4,47632,25410,22222,12563,6265,6298
521,1,21761000,3,34633,1,14110017,01/08/2022,18.5,45587,23716,21871,14000,6913,7087
522,1,13718000,3,25234,1,8891466,01/08/2022,15,37704,19683,18021,12453,6131,6322
523,1,14044000,3,20335,1,9108265,01/08/2022,15,70224,35655,34569,24421,12033,12388
524,1,3991000,3,22653,1,2571497,01/08/2022,15,17978,9382,8596,6248,3105,3143
525,1,1895000,3,24226,1,1207524,01/08/2022,15,13401,6929,6472,4288,2149,2139
526,1,1784000,3,16083,1,1143517,01/08/2022,15,30417,15670,14747,9405,4719,4686
527,1,7422000,3,29856,1,4794444,01/08/2022,15,28657,14853,13804,9078,4552,4526
528,1,1380000,3,11206,1,885794,01/08/2022,15,1583,826,757,480,230,250
529,2,58660000,2,84355,2,38044645,01/08/2022,23.8,139075,74465,64610,36819,18286,18533
530,2,64838000,2,86358,2,42058342,01/08/2022,22,120500,65043,55457,29046,14403,14643
531,2,69035000,2,53941,2,44818809,01/08/2022,26,101336,54039,47297,24763,12096,12667
532,3,147880000,1,309743,3,95812257,01/08/2022,28,405952,215818,190134,89205,43880,45325
533,2,61848000,1,106119,2,40095081,01/08/2022,27.5,212540,111746,100794,51580,25268,26312
534,2,66118000,1,129666,2,42847034,01/08/2022,29.8,180057,96347,83710,45301,22589,22712
535,2,76270000,1,198048,2,49377452,01/08/2022,21.6,443063,237967,205096,110147,54509,55638
536,1,26048000,3,30702,1,16900498,01/08/2022,29.5,33226,17650,15576,10241,5095,5146
537,1,9873000,3,25322,1,6392128,01/08/2022,28.4,15512,8193,7319,4859,2440,2419
538,2,44106000,2,60517,2,28608383,01/08/2022,26.8,64445,34215,30230,17692,8626,9066
539,2,39639000,3,49681,2,25715669,01/08/2022,28.7,48567,25769,22798,13570,6693,6877
540,1,23235000,3,25105,1,15077645,01/08/2022,15.1,42451,22342,20109,14824,7241,7583
541,1,18614000,3,28993,1,12070107,01/08/2022,30.6,41588,21739,19849,12522,6161,6361
543,1,26292000,3,45947,1,17043853,01/08/2022,29.8,55452,29697,25755,14940,7380,7560
544,1,2022000,3,22140,1,1292160,01/08/2022,28,6076,3180,2896,1703,844,859
545,2,43416000,2,59768,2,28160632,01/08/2022,29.8,64692,34002,30690,19678,9778,9900
546,1,4439000,3,25665,1,2859685,01/08/2022,28.1,22760,12125,10635,6420,3229,3191
547,1,16358000,3,36750,1,10595950,01/08/2022,29.7,25608,13480,12128,7723,3870,3853
548,1,11074000,2,55806,1,7142294,01/08/2022,26.8,15733,8506,7227,4079,2054,2025
549,1,7790000,3,25700,1,5037800,01/08/2022,22,41785,22480,19305,10854,5445,5409
550,1,10987000,3,38044,1,7103506,01/08/2022,27.9,13225,6946,6279,3476,1669,1807
551,1,15931000,3,37436,1,10317714,01/08/2022,18.8,28655,15243,13412,8764,4302,4462
552,1,7616000,3,35986,1,4914414,01/08/2022,26.7,17727,9423,8304,4199,2068,2131
553,1,13148000,2,92850,1,8453350,01/08/2022,28.4,8969,4883,4086,2821,1444,1377
554,1,12514000,3,23692,1,8110408,01/08/2022,28.7,16758,8967,7791,4993,2542,2451
555,2,37443000,3,46153,2,24291797,01/08/2022,27.8,47035,25085,21950,12872,6289,6583
556,1,20326000,3,28376,1,13183524,01/08/2022,27.8,55720,29557,26163,14521,7123,7398
557,1,21389000,3,30950,1,13871900,01/08/2022,26.3,46909,24866,22043,15156,7483,7673
558,1,13627000,3,30167,1,8827383,01/08/2022,26.3,33986,17827,16159,9043,4421,4622
559,1,11948000,3,27951,1,7738249,01/08/2022,22,34847,18666,16181,8943,4380,4563
560,1,14252000,3,35751,1,9228049,01/08/2022,27.8,14304,7545,6759,4455,2182,2273
561,1,9133000,3,26329,1,5910121,01/08/2022,27.5,20797,10995,9802,4991,2418,2573
562,1,16822000,3,23899,1,10910401,01/08/2022,28.1,30232,15727,14505,8913,4281,4632
563,1,25933000,2,61400,1,16795050,01/08/2022,28,20165,10621,9544,5395,2701,2694
564,1,2657000,3,21544,1,1705506,01/08/2022,29.8,20380,10692,9688,6259,3127,3132
565,1,11508000,3,22830,1,7457370,01/08/2022,16.4,21640,11976,9664,7433,3885,3548
566,1,19903000,3,32554,1,12904396,01/08/2022,18.9,33402,17876,15526,9753,4761,4992
567,1,23495000,3,44118,1,15227632,01/08/2022,28.6,26236,13620,12616,8067,3962,4105
568,1,4226000,3,23652,1,2723248,01/08/2022,26.9,4405,2358,2047,1451,735,716
569,1,3896000,3,25232,1,2507168,01/08/2022,27,13716,7109,6607,3981,1920,2061
570,1,12970000,3,27288,1,8403212,01/08/2022,27.8,5653,2987,2666,1709,826,883
571,1,11487000,3,29802,1,7436748,01/08/2022,29.5,21318,11472,9846,5688,2873,2815
572,1,12243000,3,23521,1,7934429,01/08/2022,27.8,14582,7621,6961,4539,2262,2277
573,1,1703000,3,30110,1,1076840,01/08/2022,28.2,6219,3311,2908,1883,941,942
574,1,10100000,3,33708,1,6531292,01/08/2022,27.7,31856,17018,14838,8563,4318,4245
575,1,17164000,3,25389,1,11131211,01/08/2022,22,35893,18883,17010,11399,5600,5799
576,1,18401000,3,26029,1,11934621,01/08/2022,29.5,19272,10328,8944,5163,2534,2629
577,1,15466000,3,27607,1,10025293,01/08/2022,14.8,16364,8711,7653,5250,2654,2596
578,1,11682000,3,27655,1,7565645,01/08/2022,28,2820,1449,1371,720,341,379
579,1,2321000,3,24300,1,1484350,01/08/2022,28.1,4654,2510,2144,1296,630,666
580,1,1512000,3,23341,1,959459,01/08/2022,14.8,21585,11243,10342,6456,3197,3259
581,1,1525000,3,26224,1,965026,01/08/2022,27.8,6888,3543,3345,1840,922,918
582,1,1931000,3,24583,1,1230567,01/08/2022,27.9,21391,11404,9987,5619,2742,2877
583,1,1784000,3,23514,1,1136086,01/08/2022,28.1,9668,5030,4638,2384,1141,1243
584,1,19470000,3,24424,1,12631076,01/08/2022,27.7,13995,7311,6684,4212,2070,2142
585,1,4665000,3,23987,1,3008263,01/08/2022,27.8,6838,3583,3255,1791,891,900
586,1,1880000,3,23514,1,1198486,01/08/2022,27.9,5681,3058,2623,1606,823,783
587,1,9791000,3,24554,1,6339596,01/08/2022,14.8,13966,7679,6287,3739,1859,1880
588,1,13107000,3,18162,1,8501388,01/08/2022,28,28076,14773,13303,7550,3752,3798
589,1,6266000,3,24028,1,4048872,01/08/2022,13.5,34039,18008,16031,8858,4334,4524
590,1,2118000,3,20101,1,1356599,01/08/2022,22,15807,8231,7576,5949,2955,2994
591,1,1271000,3,14258,1,811892,01/08/2022,27.8,10581,5508,5073,2907,1418,1489
592,1,3774000,3,23903,1,2429197,01/08/2022,19.3,9554,4935,4619,2707,1302,1405
593,1,14155000,2,53160,1,9147590,01/08/2022,26.3,9988,5342,4646,2237,1127,1110
594,1,2493000,3,14180,1,1606270,01/08/2022,29.7,7578,3984,3594,2088,1031,1057
595,1,2651000,3,25232,1,1697918,01/08/2022,20,8005,4106,3899,2599,1296,1303
596,1,3416000,3,21975,1,2198425,01/08/2022,28,24085,12288,11797,7909,3780,4129
597,1,4372000,3,22486,1,2819314,01/08/2022,27.9,7455,4054,3401,2223,1145,1078
598,1,988000,3,8676,1,633524,01/08/2022,28.2,17919,9538,8381,4548,2298,2250
599,1,4735000,3,24262,1,3053488,01/08/2022,29.8,15305,8066,7239,4706,2332,2374
600,3,164842000,1,246480,3,106900820,01/08/2022,29.1,921771,479309,442462,222551,109790,112761
601,1,16412000,3,23509,1,10644291,01/08/2022,26.1,26081,13338,12743,7626,3791,3835
602,2,32739000,3,24091,2,21256259,01/08/2022,29,56494,29131,27363,17460,8617,8843
603,1,19948000,3,26272,1,12939928,01/08/2022,28.4,52593,26982,25611,16883,8307,8576
604,1,7651000,3,31065,1,4942085,01/08/2022,28,41965,21110,20855,11192,5453,5739
605,1,9922000,3,30236,1,6419064,01/08/2022,29.1,26175,13553,12622,8885,4301,4584
606,1,14500000,3,25364,1,9399636,01/08/2022,28.3,35183,17868,17315,10650,5230,5420
607,1,11263000,3,24424,1,7296526,01/08/2022,27,56409,28489,27920,16919,8292,8627
608,1,9559000,3,11977,1,6201373,01/08/2022,29.1,139753,70456,69297,45077,22298,22779
609,1,8356000,3,23503,1,5407897,01/08/2022,28.5,17841,9042,8799,5372,2677,2695
610,1,7815000,3,22108,1,5057642,01/08/2022,29.1,28461,14574,13887,9148,4533,4615
611,2,39535000,2,61562,2,25636188,01/08/2022,20.7,143281,73905,69376,47529,23519,24010
612,2,44765000,2,100309,2,28996941,01/08/2022,16.6,138444,72335,66109,38201,18773,19428
613,1,12264000,3,24471,1,7947129,01/08/2022,22,22295,11690,10605,8176,4115,4061
614,1,15448000,3,47534,1,9993666,01/08/2022,19.1,25068,12776,12292,8673,4237,4436
615,1,3632000,3,25987,1,2334813,01/08/2022,20.5,15291,7886,7405,5051,2477,2574
616,1,5790000,3,23959,1,3739541,01/08/2022,20.5,38193,19467,18726,13775,6896,6879
617,1,11925000,3,26927,1,7724323,01/08/2022,22,46132,23831,22301,13972,6871,7101
618,1,2281000,3,21935,1,1460715,01/08/2022,23,13641,7027,6614,4307,2133,2174
1,2,99456000,1,179440,2,64466960,01/07/2022,23,863893,444725,419168,260350,128225,132125
2,1,16987000,3,26201,1,11015349,01/07/2022,23.6,31963,16433,15530,11390,5609,5781
3,1,10184000,3,25644,1,6593956,01/07/2022,21.6,63805,32406,31399,23397,11652,11745
4,1,9950000,3,27700,1,6439800,01/07/2022,23.6,21049,10874,10175,7097,3529,3568
5,1,5211000,3,22961,1,3364189,01/07/2022,21.4,32035,16367,15668,10989,5374,5615
6,3,204160000,1,250949,3,132453051,01/07/2022,38,854186,425977,428209,227917,112151,115766
7,3,420576000,1,541744,3,272832656,01/07/2022,21.2,1810645,899293,911352,503963,246971,256992
8,2,90503000,2,95391,2,58731559,01/07/2022,21,330652,167339,163313,86895,42903,43992
9,2,36273000,3,27004,2,23550446,01/07/2022,24.5,81059,40420,40639,23492,11470,12022
10,2,34939000,3,51843,2,22658507,01/07/2022,21.6,100660,49935,50725,28067,13772,14295
11,1,20942000,3,26146,1,13586154,01/07/2022,34.1,19081,9476,9605,5934,2909,3025
12,2,77042000,1,122567,2,49954733,01/07/2022,32.4,250141,126245,123896,65670,32312,33358
13,2,54749000,2,83098,2,35503752,01/07/2022,27.6,136285,66083,70202,42780,21001,21779
14,2,77093000,1,117535,2,49992915,01/07/2022,29.9,202694,98608,104086,64935,31858,33077
15,1,24623000,3,40026,1,15964924,01/07/2022,28.5,43805,22160,21645,13050,6507,6543
16,1,26454000,2,68597,1,17126503,01/07/2022,32.2,16311,8010,8301,4984,2435,2549
17,1,9791000,3,26322,1,6337828,01/07/2022,28.9,14357,6822,7535,3854,1925,1929
18,1,3151000,3,22088,1,2026062,01/07/2022,21,13596,6842,6754,4196,2086,2110
19,1,9737000,3,24649,1,6304401,01/07/2022,25.4,13596,6842,6754,4196,2086,2110
20,1,3401000,3,23742,1,2186908,01/07/2022,26.3,7185,3509,3676,2099,1015,1084
21,2,43612000,2,67689,2,28280111,01/07/2022,29.5,191238,97313,93925,52600,25862,26738
22,2,40850000,2,79994,2,26472506,01/07/2022,29.3,249623,130524,119099,66498,32635,33863
23,1,26210000,3,25793,1,17010707,01/07/2022,29.4,31375,16375,15000,10682,5317,5365
24,1,18187000,3,26580,1,11794970,01/07/2022,28.7,35799,18291,17508,11962,5883,6079
25,1,11634000,3,30359,1,7531741,01/07/2022,30.3,15949,8217,7732,4538,2234,2304
26,2,82887000,2,92287,2,53784263,01/07/2022,29.1,217550,113613,103937,65123,32048,33075
27,2,47890000,3,45475,2,31083025,01/07/2022,17.9,183509,96930,86579,60413,30246,30167
28,2,50263000,2,63990,2,32606960,01/07/2022,20.5,113479,60064,53415,36594,18199,18395
29,3,103534000,1,110387,3,67186713,01/07/2022,27.4,578830,303756,275074,166456,82025,84431
30,2,39775000,3,45834,2,25807916,01/07/2022,28.3,51797,27093,24704,17614,8812,8802
31,2,60348000,1,127393,2,39098807,01/07/2022,27,38087,20017,18070,11916,5833,6083
32,1,13552000,3,22780,1,8786020,01/07/2022,30,32109,16780,15329,10495,5074,5421
33,1,24560000,3,22272,1,15941728,01/07/2022,25.1,21727,11415,10312,7786,3890,3896
34,1,17227000,3,27735,1,11169815,01/07/2022,27.2,49201,25651,23550,16539,8102,8437
35,1,25105000,3,35489,1,16282761,01/07/2022,26.1,37546,19668,17878,11791,5836,5955
36,1,23154000,2,75513,1,14974587,01/07/2022,19.8,47688,25247,22441,17870,8920,8950
37,1,5252000,3,23004,1,3390796,01/07/2022,28.7,55931,28786,27145,18430,9082,9348
38,1,12782000,3,26665,1,8281635,01/07/2022,24.9,29018,15064,13954,10291,5191,5100
39,1,11187000,3,22476,1,7249074,01/07/2022,26,18219,9592,8627,5806,2838,2968
40,1,14842000,3,25113,1,9622187,01/07/2022,28.7,15244,8058,7186,4848,2429,2419
41,1,4821000,3,22065,1,3111585,01/07/2022,30,25366,13345,12021,7752,3823,3929
42,1,18963000,3,23159,1,12302791,01/07/2022,27.5,19271,9996,9275,6517,3095,3422
43,1,4440000,3,20478,1,2865522,01/07/2022,28.5,7662,4073,3589,2321,1153,1168
45,3,320376000,1,249958,3,207994442,01/07/2022,29.9,1501551,750157,751394,459910,225614,234296
46,3,113565000,1,190526,3,73626724,01/07/2022,27,925762,474776,450986,250961,123448,127513
47,2,33537000,2,53097,2,21745953,01/07/2022,30,128548,65838,62710,37721,18411,19310
48,1,26095000,3,43525,1,16918225,01/07/2022,22.5,135586,69677,65909,41627,20458,21169
49,2,34543000,2,65985,2,22386965,01/07/2022,25.7,113843,59214,54629,34117,16974,17143
50,1,6095000,3,21626,1,3940124,01/07/2022,31.2,23140,11693,11447,7155,3499,3656
51,1,10279000,3,24581,1,6656769,01/07/2022,26.3,35087,17902,17185,11563,5663,5900
52,1,14049000,3,34397,1,9097453,01/07/2022,28.1,42019,21548,20471,12599,6234,6365
53,1,10452000,3,31209,1,6762591,01/07/2022,33.7,22066,11231,10835,6719,3420,3299
54,1,9556000,3,25055,1,6186345,01/07/2022,17.7,17410,9121,8289,6393,3204,3189
55,1,2337000,3,22272,1,1496778,01/07/2022,28.4,22568,11549,11019,7200,3540,3660
56,1,8003000,3,23082,1,5178868,01/07/2022,23.4,15054,7516,7538,5557,2768,2789
57,1,3945000,2,70235,1,2494015,01/07/2022,25.2,8253,4210,4043,2801,1419,1382
58,1,5388000,3,22013,1,3480187,01/07/2022,21.2,7834,4065,3769,2439,1200,1239
59,1,2247000,3,21008,1,1439542,01/07/2022,17.8,14755,7617,7138,4907,2427,2480
60,1,12873000,3,28451,1,8338999,01/07/2022,26.1,62038,31762,30276,19262,9511,9751
61,3,108505000,1,119782,3,70408468,01/07/2022,31.2,690193,353744,336449,203574,99881,103693
62,3,140895000,1,203221,3,91378529,01/07/2022,24.4,864431,434753,429678,267728,131619,136109
63,2,46918000,2,79490,2,30417210,01/07/2022,33.2,237169,119538,117631,71348,35023,36325
64,2,51432000,2,68741,2,33362059,01/07/2022,34.4,173959,86825,87134,55826,27459,28367
65,1,11903000,3,24365,1,7712585,01/07/2022,32,39058,19755,19303,11201,5479,5722
66,3,120928000,1,163232,3,78439968,01/07/2022,30.4,59762,30506,29256,20025,9931,10094
67,1,16457000,3,24608,1,10672442,01/07/2022,31.3,49490,25496,23994,16916,8460,8456
68,2,30825000,2,54207,2,19982043,01/07/2022,32.2,160225,79799,80426,53549,26489,27060
69,1,17761000,3,21833,1,11522817,01/07/2022,24.5,114010,56192,57818,38156,18905,19251
70,1,25557000,3,36880,1,16575170,01/07/2022,30.3,75242,37695,37547,23792,11778,12014
71,1,12354000,3,24874,1,8005226,01/07/2022,33.2,59196,29915,29281,18125,8949,9176
72,1,17411000,3,23452,1,11293698,01/07/2022,30.8,32704,16713,15991,11320,5572,5748
73,1,7431000,3,25512,1,4804638,01/07/2022,32,23413,11884,11529,7157,3552,3605
74,1,10187000,3,25985,1,6595565,01/07/2022,31.8,38992,19602,19390,13022,6299,6723
75,1,1996000,3,23016,1,1274384,01/07/2022,32.9,27314,13703,13611,9005,4397,4608
76,2,56998000,2,68790,2,36979910,01/07/2022,26.5,146965,75962,71003,46271,22786,23485
77,2,32085000,3,45953,2,20809297,01/07/2022,31,88337,44762,43575,34686,17254,17432
78,2,43618000,2,70244,2,28281456,01/07/2022,30.1,159853,80569,79284,57402,28064,29338
79,1,2966000,3,21722,1,1906178,01/07/2022,26.5,9746,4912,4834,3336,1602,1734
80,1,2402000,3,21359,1,1539941,01/07/2022,29.7,15368,7632,7736,5699,2779,2920
81,1,1378000,3,8901,1,886799,01/07/2022,28,147496,76348,71148,49524,24280,25244
82,1,1259000,3,22806,1,795544,01/07/2022,28.2,14892,7420,7472,5365,2615,2750
83,1,8728000,3,23651,1,5649549,01/07/2022,30.9,34798,17459,17339,10865,5211,5654
84,2,40602000,1,179240,2,26212060,01/07/2022,20.1,432205,227255,204950,86717,42372,44345
85,2,43340000,1,174874,2,27996126,01/07/2022,20.1,759003,398068,360935,168014,83097,84917
86,2,94731000,1,330361,2,61244789,01/07/2022,20.6,1173351,609477,563874,261635,129105,132530
87,1,27750000,2,61060,1,17976440,01/07/2022,20.8,414470,219003,195467,75588,37198,38390
88,1,18812000,2,54581,1,12173219,01/07/2022,18.7,186693,97615,89078,46165,22603,23562
89,3,160122000,1,401159,3,103678141,01/07/2022,20.1,1835486,947835,887651,451632,222341,229291
90,2,53232000,1,118912,2,34481888,01/07/2022,20.1,614447,325337,289110,113945,55951,57994
91,1,26979000,2,85982,1,17450368,01/07/2022,19.6,434153,232032,202121,62030,30612,31418
92,2,53597000,1,123425,2,34714625,01/07/2022,19.3,323771,167274,156497,83659,40990,42669
93,2,46660000,2,91567,2,30237433,01/07/2022,18.1,404695,212343,192352,85496,42058,43438
94,1,27250000,1,150960,1,17561540,01/07/2022,19.8,443704,233586,210118,95713,47173,48540
95,2,62831000,1,247601,2,40592549,01/07/2022,20,545884,284933,260951,101794,50260,51534
96,1,15607000,2,56617,1,10087933,01/07/2022,18.4,429481,220393,209088,105785,52018,53767
97,1,9264000,3,49463,1,5972137,01/07/2022,15.2,246428,128767,117661,58169,28791,29378
98,1,12684000,3,30346,1,8214254,01/07/2022,15.2,599935,314284,285651,130174,64060,66114
99,3,128320000,1,151660,3,83256340,01/07/2022,23.9,616068,317266,298802,191866,94056,97810
100,2,79626000,2,90977,2,51665923,01/07/2022,23.9,301742,154079,147663,97495,48007,49488
101,1,10300000,3,19488,1,6675512,01/07/2022,28.8,96243,49040,47203,29383,14345,15038
102,1,20713000,3,34570,1,13428880,01/07/2022,25.1,30063,15334,14729,10450,5151,5299
103,1,1465000,2,92405,1,859845,01/07/2022,28.8,3222,1654,1568,1247,637,610
104,1,13402000,2,53758,1,8657542,01/07/2022,21.9,17967,9205,8762,6003,2945,3058
105,1,2262000,3,21030,1,1449270,01/07/2022,22.6,11943,6311,5632,3854,1993,1861
106,1,2073000,2,89921,1,1257529,01/07/2022,26.3,12850,6538,6312,4678,2267,2411
107,2,39421000,2,102913,2,25520737,01/07/2022,15.9,26678,13733,12945,10032,4897,5135
108,3,173185000,1,243130,3,112327120,01/07/2022,16.5,223876,119352,104524,50306,24928,25378
109,2,59262000,1,190867,2,38329433,01/07/2022,18.1,515353,266081,249272,126007,61695,64312
110,3,101221000,1,305902,3,65487748,01/07/2022,18.2,776220,402522,373698,193769,95439,98330
111,2,60964000,2,92032,2,39534568,01/07/2022,17.5,84298,43745,40553,23019,11356,11663
112,2,45958000,2,57835,2,29814865,01/07/2022,19.4,30929,15848,15081,8319,4034,4285
113,2,30991000,1,115462,2,20028688,01/07/2022,18.7,293245,152241,141004,70657,34731,35926
114,2,58241000,1,215382,2,37641268,01/07/2022,18.1,658907,338453,320454,150053,73914,76139
115,1,25506000,3,30105,1,16548795,01/07/2022,18.1,117995,60165,57830,29983,14851,15132
116,3,166557000,1,316593,3,107945457,01/07/2022,16.2,1643623,845932,797691,437489,216020,221469
117,2,72553000,1,155511,2,47003939,01/07/2022,21.5,368585,190133,178452,107535,52900,54635
118,2,43332000,2,63932,2,28101868,01/07/2022,13.7,174704,91497,83207,54449,28355,26094
119,1,19891000,3,48286,1,12880864,01/07/2022,11.3,2931,1520,1411,975,512,463
120,2,55913000,1,123244,2,36220206,01/07/2022,10.5,35491,18986,16505,7987,3993,3994
121,2,62720000,1,157306,2,40610694,01/07/2022,17.5,703215,359601,343614,230612,113552,117060
122,2,61379000,1,197452,2,39698898,01/07/2022,18.8,18226,9300,8926,5308,2603,2705
123,2,50154000,2,75639,2,32524461,01/07/2022,19.9,1072676,556998,515678,265425,131078,134347
124,1,23708000,3,11074,1,15399126,01/07/2022,21.1,14038,7254,6784,3763,1910,1853
125,2,68877000,2,97939,2,44672111,01/07/2022,13.7,174704,91497,83207,54449,28355,26094
126,2,54665000,3,31641,2,35500609,01/07/2022,16.1,7077,3593,3484,1748,893,855
127,2,36687000,2,52893,2,23793657,01/07/2022,19.9,53362,27304,26058,15169,7515,7654
128,1,16966000,3,23031,1,11004869,01/07/2022,6.1,24612,12254,12358,7339,3541,3798
129,2,48434000,1,170384,2,31311716,01/07/2022,19.2,10873,5623,5250,3757,1878,1879
130,2,58702000,2,55669,2,38100631,01/07/2022,15.4,23219,12339,10880,6425,3186,3239
131,1,24946000,3,33391,1,16181509,01/07/2022,18.2,12671,6512,6159,3454,1710,1744
132,1,22649000,3,29927,1,14691923,01/07/2022,16,30967,16277,14690,10756,5327,5429
133,2,39447000,2,55426,2,25585124,01/07/2022,18.3,323545,166328,157217,93932,46757,47175
134,1,7302000,3,18595,1,4727705,01/07/2022,23.6,19326,10155,9171,6252,3129,3123
135,1,21235000,3,29145,1,13773605,01/07/2022,13.7,33716,17686,16030,9317,4624,4693
136,1,12688000,3,48286,1,8198914,01/07/2022,17.8,40279,20716,19563,10282,5078,5204
137,1,3856000,3,22885,1,2483515,01/07/2022,18.4,29068,14916,14152,8580,4220,4360
138,1,28129000,2,55990,1,18227860,01/07/2022,18.8,12752,6694,6058,3471,1768,1703
139,1,4984000,3,48640,1,3190960,01/07/2022,16.1,33166,16973,16193,9497,4707,4790
140,1,6354000,3,15354,1,4114746,01/07/2022,18.1,52828,27143,25685,16500,8128,8372
141,2,32214000,3,26537,2,20912563,01/07/2022,17,32738,16941,15797,9059,4431,4628
142,1,9013000,3,28657,1,5829793,01/07/2022,18.4,30203,15792,14411,7568,3777,3791
143,2,31477000,3,39047,2,20421003,01/07/2022,18.1,11760,6069,5691,3432,1700,1732
144,1,9639000,3,21062,1,6244288,01/07/2022,19.9,72525,37076,35449,22128,10944,11184
145,1,8243000,3,24935,1,5333015,01/07/2022,11.3,18580,9729,8851,5724,2801,2923
146,1,18945000,3,29702,1,12284548,01/07/2022,18.8,24575,12798,11777,7126,3453,3673
147,1,1345000,3,19014,1,855236,01/07/2022,18.7,44731,22925,21806,13335,6514,6821
148,1,7949000,2,53184,1,5113666,01/07/2022,16.8,658907,338453,320454,150053,73914,76139
149,1,14642000,3,24580,1,9492720,01/07/2022,18.6,10336,5387,4949,3449,1664,1785
150,1,12231000,3,42139,1,7908011,01/07/2022,14.7,4656,2421,2235,1533,751,782
151,1,6866000,3,30769,1,4432131,01/07/2022,18.3,9598,5002,4596,2910,1467,1443
152,1,10813000,3,21629,1,7006821,01/07/2022,18.1,15171,7853,7318,4470,2251,2219
153,1,6757000,3,23270,1,4368780,01/07/2022,18.4,10792,5577,5215,3492,1713,1779
154,1,2012000,3,3763,1,1304037,01/07/2022,18.1,37442,19141,18301,12089,5963,6126
155,1,3218000,3,22088,1,2069612,01/07/2022,13.7,17736,9182,8554,5577,2775,2802
156,1,8238000,3,12747,1,5341953,01/07/2022,18.8,386290,199249,187041,112223,55337,56886
157,1,8802000,3,29513,1,5691787,01/07/2022,18.8,9925,5218,4707,2833,1403,1430
158,1,9197000,3,23892,1,5954158,01/07/2022,21.1,6944,3666,3278,2341,1149,1192
159,1,6594000,3,28172,1,4257928,01/07/2022,16.2,88734,45471,43263,28316,14166,14150
160,1,8240000,3,21032,1,5334968,01/07/2022,10.5,6449,3346,3103,1687,833,854
161,1,6681000,3,21879,1,4320771,01/07/2022,16.2,10735,5576,5159,3010,1518,1492
162,1,2668000,3,21551,1,1712649,01/07/2022,10.5,10810,5614,5196,2941,1451,1490
163,1,1162000,3,752,1,754548,01/07/2022,28.5,13038,6614,6424,4157,2015,2142
165,3,171446000,1,227418,3,111212482,01/07/2022,22.7,1579803,804212,775591,594938,292494,302444
166,2,76191000,2,81638,2,49442512,01/07/2022,20.5,378143,194849,183294,128863,62806,66057
167,2,70591000,2,54636,2,45829514,01/07/2022,23.3,452090,230346,221744,162764,80177,82587
168,1,23060000,3,32589,1,14956411,01/07/2022,23.2,69371,35473,33898,25304,12303,13001
169,2,31239000,2,66902,2,20238448,01/07/2022,21.6,79772,40908,38864,30907,15312,15595
170,1,22281000,3,37235,1,14445415,01/07/2022,20.7,56597,29703,26894,19146,9514,9632
171,1,24527000,3,35105,1,15907445,01/07/2022,21.7,72663,38036,34627,27395,13712,13683
172,2,46858000,2,78711,2,30378989,01/07/2022,22.7,160682,83178,77504,52342,25860,26482
173,2,29322000,3,33860,2,19025440,01/07/2022,21.4,83352,42766,40586,32937,16375,16562
174,2,29080000,3,36883,2,18865117,01/07/2022,20.3,67101,35567,31534,27008,13393,13615
175,1,17856000,3,37865,1,11568535,01/07/2022,21.1,43249,22352,20897,17065,8284,8781
176,1,25286000,3,23794,1,16412106,01/07/2022,21.1,51894,27702,24192,20579,10113,10466
177,1,21717000,3,51136,1,14064914,01/07/2022,22.5,70068,36526,33542,21044,10402,10642
178,1,20413000,3,26490,1,13241960,01/07/2022,21.6,52156,27081,25075,17108,8394,8714
179,1,3722000,3,31259,1,2388041,01/07/2022,21.5,41910,21741,20169,12631,6146,6485
180,1,22068000,3,45267,1,14298933,01/07/2022,21.2,43998,23109,20889,17575,8775,8800
181,1,5391000,3,23590,1,3480560,01/07/2022,23.9,24757,12827,11930,9816,4898,4918
182,1,3780000,3,22361,1,2434639,01/07/2022,20.3,21756,11234,10522,8659,4317,4342
183,1,8700000,3,14627,1,5640373,01/07/2022,21.2,28109,14419,13690,10548,5187,5361
184,1,6146000,3,25046,1,3969854,01/07/2022,23.5,15305,7996,7309,5899,2872,3027
185,1,24935000,3,51224,1,16156526,01/07/2022,20.3,72452,38019,34433,23628,11618,12010
186,1,16613000,3,24233,1,10774217,01/07/2022,21.5,35401,18444,16957,12235,5945,6290
187,1,24470000,3,26322,1,15879178,01/07/2022,21.2,27593,14289,13304,10803,5260,5543
188,1,18665000,3,24115,1,12108135,01/07/2022,22.7,31264,16171,15093,9806,4840,4966
189,1,17701000,3,26322,1,11479328,01/07/2022,18,24228,12861,11367,9383,4674,4709
190,1,19566000,3,22751,1,12695149,01/07/2022,18.4,32831,17049,15782,13856,6706,7150
191,1,2868000,3,22518,1,1841682,01/07/2022,22.5,16092,8507,7585,6837,3451,3386
192,1,7938000,3,27735,1,5131965,01/07/2022,19.2,8011,4268,3743,3134,1562,1572
193,1,14392000,3,25802,1,9328998,01/07/2022,23.5,29002,14796,14206,11206,5550,5656
194,1,2723000,3,22465,1,1747485,01/07/2022,19.2,7946,4172,3774,3293,1607,1686
195,1,10605000,3,11718,1,6881532,01/07/2022,22.6,28260,14728,13532,11002,5473,5529
196,1,6417000,3,5170,1,4165880,01/07/2022,21.2,25845,13471,12374,9370,4627,4743
197,3,143780000,1,186571,3,93270429,01/07/2022,28.9,658609,345979,312630,183298,90145,93153
198,2,56366000,2,59438,2,36578462,01/07/2022,23.7,225728,119129,106599,71494,35347,36147
199,2,34709000,3,43030,2,22517820,01/07/2022,32.4,70760,36613,34147,21788,10705,11083
200,2,46650000,2,78908,2,30243592,01/07/2022,26,132854,69610,63244,41183,20301,20882
201,1,18619000,2,57206,1,12045144,01/07/2022,21.4,50399,26542,23857,14000,6918,7082
202,1,3189000,3,22893,1,2049957,01/07/2022,23.4,27944,14419,13525,9490,4664,4826
203,1,6775000,3,25068,1,4378682,01/07/2022,21.3,22534,11802,10732,7926,3939,3987
204,1,15908000,3,37442,1,10302758,01/07/2022,27.1,25148,13436,11712,8928,4476,4452
205,1,27223000,3,48104,1,17646846,01/07/2022,22.4,33783,18241,15542,12201,6089,6112
206,2,33068000,3,31724,2,21462476,01/07/2022,27,25850,13268,12582,8390,4048,4342
208,2,41079000,3,34618,2,26666732,01/07/2022,20.4,27607,14605,13002,9883,5002,4881
209,1,10088000,3,24917,1,6532283,01/07/2022,27.6,13866,7187,6679,4383,2099,2284
210,1,7973000,3,26254,1,5156196,01/07/2022,27.1,23363,12127,11236,7776,3818,3958
211,1,18227000,3,25856,1,11821694,01/07/2022,25.7,18224,9500,8724,7072,3514,3558
212,1,14928000,3,25134,1,9678066,01/07/2022,29,16447,8464,7983,4843,2381,2462
213,1,7027000,3,13724,1,4553826,01/07/2022,24.5,17550,9283,8267,5700,2861,2839
214,2,67675000,1,156235,2,43832515,01/07/2022,18.5,297848,156299,141549,74787,37046,37741
215,1,27131000,3,32796,1,17602354,01/07/2022,20.2,29390,15521,13869,7939,3942,3997
216,2,35262000,2,55252,2,22865048,01/07/2022,21.2,37608,20094,17514,11115,5490,5625
217,2,40672000,2,72351,2,26364449,01/07/2022,18.7,106163,56161,50002,30752,15034,15718
218,1,14320000,3,43523,1,9264477,01/07/2022,16.8,11149,5894,5255,2996,1479,1517
219,2,37314000,2,56569,2,24197531,01/07/2022,16.1,60265,30945,29320,18808,9224,9584
220,1,21343000,3,32079,1,13840871,01/07/2022,21.3,17718,9411,8307,4913,2492,2421
221,1,19332000,3,32132,1,12533668,01/07/2022,20,36618,19077,17541,10530,5273,5257
222,1,12237000,3,25078,1,7928972,01/07/2022,20.5,9853,5224,4629,2757,1390,1367
223,1,2904000,3,25541,1,1862059,01/07/2022,20.2,27713,14561,13152,7736,3885,3851
224,1,7649000,3,22355,1,4949495,01/07/2022,19.4,32276,17014,15262,9457,4578,4879
225,1,8732000,3,23850,1,5651950,01/07/2022,20.5,14689,7582,7107,4123,2033,2090
226,2,44350000,3,32556,2,28794944,01/07/2022,28.7,44311,23331,20980,13756,6771,6985
227,1,4724000,3,23004,1,3047596,01/07/2022,22.2,14732,7791,6941,4911,2433,2478
228,1,11923000,3,24702,1,7725248,01/07/2022,18.6,20530,10890,9640,6356,3180,3176
229,1,13627000,3,23771,1,8833779,01/07/2022,27.8,16368,8558,7810,4728,2323,2405
230,1,9174000,3,24236,1,5938864,01/07/2022,15.1,6213,3216,2997,1786,871,915
231,1,11218000,3,25098,1,7266602,01/07/2022,16.1,28792,15288,13504,8327,4111,4216
233,1,5074000,3,6433,1,3291667,01/07/2022,19.3,8657,4501,4156,2464,1200,1264
234,2,72022000,1,114087,2,46700213,01/07/2022,28.1,224166,112147,112019,65088,31954,33134
235,2,29347000,2,54904,2,19020646,01/07/2022,21.9,111569,57370,54199,36412,17892,18520
236,2,29443000,3,32447,2,19105503,01/07/2022,22.7,38780,20122,18658,13025,6461,6564
237,3,156021000,1,358201,3,101055449,01/07/2022,21,1385621,718628,666993,333198,164217,168981
238,3,105953000,1,248659,3,68620791,01/07/2022,21.8,1257547,645398,612149,321993,158559,163434
239,1,21429000,3,29759,1,13899091,01/07/2022,23.8,37871,19554,18317,11359,5732,5627
240,2,87190000,1,217252,2,56456248,01/07/2022,24.2,650123,329365,320758,200033,98558,101475
241,2,41197000,2,74638,2,26703412,01/07/2022,23,111975,57735,54240,31481,15460,16021
242,1,14241000,3,26152,1,9230498,01/07/2022,22.7,98842,50427,48415,30938,15263,15675
243,2,67191000,1,195310,2,43478840,01/07/2022,22.2,44103,22420,21683,15768,7755,8013
244,1,11036000,3,26423,1,7146977,01/07/2022,22.6,53539,27205,26334,18000,8916,9084
245,1,11154000,3,26374,1,7223726,01/07/2022,29.2,18787,9476,9311,6502,3270,3232
246,1,17152000,3,36024,1,11112776,01/07/2022,22.7,59648,30609,29039,19344,9536,9808
247,2,58571000,2,104601,2,37966549,01/07/2022,23,30471,15635,14836,9610,4654,4956
248,1,4265000,3,22961,1,2749289,01/07/2022,22.6,20286,10307,9979,6804,3413,3391
249,1,4532000,3,21074,1,2924726,01/07/2022,22.9,20345,10131,10214,6733,3300,3433
250,1,20373000,3,38939,1,13203511,01/07/2022,22.6,31115,15891,15224,10525,5240,5285
251,1,13217000,3,40818,1,8550232,01/07/2022,22.6,16550,8456,8094,5252,2552,2700
252,1,17225000,3,26144,1,11170106,01/07/2022,22.7,24352,12627,11725,8092,4062,4030
253,1,18755000,3,44814,1,12145936,01/07/2022,21,94978,48709,46269,29794,14672,15122
254,1,20951000,3,29223,1,13588927,01/07/2022,26.1,52019,26739,25280,15725,7759,7966
255,1,3777000,3,25512,1,2429538,01/07/2022,22.7,24580,12765,11815,8215,4057,4158
256,1,14031000,3,28320,1,9091830,01/07/2022,25.8,28678,14679,13999,9074,4497,4577
257,1,4447000,3,21462,1,2869088,01/07/2022,16.5,22738,11719,11019,7000,3537,3463
258,1,11626000,3,24547,1,7532353,01/07/2022,23,28145,14670,13475,8863,4390,4473
259,1,9523000,3,26244,1,6163706,01/07/2022,23,19113,9852,9261,5504,2716,2788
260,1,2020000,3,21462,1,1291538,01/07/2022,22.6,25925,13382,12543,8585,4189,4396
261,1,1010000,3,22645,1,633855,01/07/2022,25.8,13033,6697,6336,4420,2181,2239
262,1,2727000,3,21969,1,1750581,01/07/2022,10.8,5955,3118,2837,1972,974,998
263,1,1494000,3,17515,1,953585,01/07/2022,22.6,8850,4524,4326,2773,1377,1396
264,1,2334000,3,20220,1,1496880,01/07/2022,16.5,9529,4943,4586,3018,1490,1528
265,1,10307000,3,29483,1,6670067,01/07/2022,22.6,14636,7533,7103,4910,2424,2486
266,1,17520000,3,32988,1,11355012,01/07/2022,22.6,40906,20800,20106,12864,6409,6455
267,1,6886000,3,24377,1,4451523,01/07/2022,23,8142,4289,3853,2686,1333,1353
268,1,2141000,3,22615,1,1369035,01/07/2022,16.5,7954,4060,3894,2570,1274,1296
269,1,10800000,3,25270,1,6994730,01/07/2022,22.6,17000,8527,8473,5215,2549,2666
270,1,3465000,3,22314,1,2229936,01/07/2022,21.4,14424,7439,6985,5399,2678,2721
271,1,2384000,3,21790,1,1527810,01/07/2022,22.6,16873,8725,8148,6022,3008,3014
272,1,3535000,3,18018,1,2279732,01/07/2022,23,5109,2618,2491,1631,805,826
273,1,2281000,3,22021,1,1460629,01/07/2022,23,13243,6795,6448,4043,1954,2089
274,1,2698000,3,21806,1,1731894,01/07/2022,22.6,14497,7627,6870,4260,2099,2161
275,1,2453000,3,18881,1,1575569,01/07/2022,22.6,16324,8373,7951,5562,2774,2788
276,1,5774000,3,22331,1,3730769,01/07/2022,28.4,9842,5047,4795,3323,1629,1694
277,1,2987000,3,21030,1,1920520,01/07/2022,22.6,27833,14525,13308,9097,4581,4516
278,1,4906000,3,4845,1,3184055,01/07/2022,22.5,33284,17172,16112,10804,5349,5455
279,1,2092000,3,22053,1,1337747,01/07/2022,24.8,14697,7601,7096,4740,2380,2360
280,1,4550000,3,18948,1,2938552,01/07/2022,21,18607,9363,9244,6403,3178,3225
284,3,109124000,1,161577,3,70769023,01/07/2022,19.4,743275,388114,355161,202467,99875,102592
285,2,39754000,2,92345,2,25747755,01/07/2022,17.1,154546,80401,74145,48513,24003,24510
286,2,71506000,1,128702,2,46350198,01/07/2022,20.1,299523,155411,144112,93845,46362,47483
287,2,54055000,2,86509,2,35049241,01/07/2022,29.5,83637,42325,41312,24783,12286,12497
288,2,38349000,2,80498,2,24846352,01/07/2022,29.1,102362,52461,49901,35162,17416,17746
289,1,18187000,3,33278,1,11788272,01/07/2022,22.5,55287,28877,26410,16959,8447,8512
290,1,22974000,3,38023,1,14895077,01/07/2022,23.4,87042,45232,41810,26414,12958,13456
291,2,39146000,2,61489,2,25383411,01/07/2022,12.5,86901,45620,41281,26262,13160,13102
292,1,21879000,3,23082,1,14198268,01/07/2022,20.5,30519,15931,14588,10809,5325,5484
293,2,32742000,2,64176,2,21218124,01/07/2022,19.5,60811,31893,28918,19713,9706,10007
294,1,3421000,3,12747,1,2210903,01/07/2022,17.7,61510,31765,29745,21000,10487,10513
295,1,23505000,3,48511,1,15229739,01/07/2022,19.4,70042,36241,33801,21818,10809,11009
296,1,4811000,3,14397,1,3112753,01/07/2022,21.4,24662,12965,11697,6937,3350,3587
297,1,6132000,3,18980,1,3966820,01/07/2022,17.7,15414,7999,7415,4635,2291,2344
298,1,24915000,3,21586,1,16173164,01/07/2022,18.4,71528,37497,34031,23278,11539,11739
299,1,2387000,3,21462,1,1530088,01/07/2022,20.5,15249,7932,7317,4894,2453,2441
300,1,28164000,3,23082,1,18283518,01/07/2022,19.6,39425,20578,18847,13203,6477,6726
301,1,4216000,3,21462,1,2718938,01/07/2022,21.4,17293,8766,8527,5650,2795,2855
302,1,12201000,3,22961,1,7907689,01/07/2022,12.5,16905,8772,8133,5514,2740,2774
303,1,4874000,3,21914,1,3146186,01/07/2022,19.5,18097,9360,8737,5881,2892,2989
304,1,13288000,3,23286,1,8613914,01/07/2022,21.5,32333,16690,15643,10314,5057,5257
305,1,19163000,3,24717,1,12431233,01/07/2022,20,49940,25545,24395,16071,7998,8073
306,1,17992000,3,27553,1,11667247,01/07/2022,20.3,1049,546,503,282,149,133
307,1,15278000,3,28146,1,9902554,01/07/2022,20.1,6853,3584,3269,2311,1149,1162
308,1,8037000,3,4845,1,5219205,01/07/2022,27.5,12262,6119,6143,4251,2104,2147
309,1,3078000,3,19198,1,1981502,01/07/2022,20,11086,5609,5477,3615,1780,1835
310,1,2638000,3,27363,1,1687337,01/07/2022,23.4,13821,7083,6738,3938,1966,1972
311,2,53189000,1,156569,2,34416281,01/07/2022,22.8,341029,180370,160659,82444,40670,41774
312,2,73993000,2,104411,2,47991039,01/07/2022,24,157336,82380,74956,43883,21497,22386
313,1,23127000,3,20380,1,15012170,01/07/2022,27,174629,91268,83361,46521,22880,23641
314,2,33303000,3,50953,2,21595997,01/07/2022,25.6,104461,54150,50311,30967,15315,15652
315,1,16664000,3,49635,1,10781965,01/07/2022,24.9,44353,23038,21315,13070,6400,6670
316,1,4930000,3,24125,1,3180375,01/07/2022,26.6,21375,11206,10169,5662,2753,2909
317,2,33295000,3,41305,2,21600445,01/07/2022,27,17777,9225,8552,4254,2086,2168
318,2,40048000,2,98255,2,25932945,01/07/2022,27,64084,32934,31150,19785,9668,10117
319,1,15276000,3,23183,1,9906217,01/07/2022,26.7,20434,10867,9567,5939,2970,2969
320,1,15629000,3,29662,1,10129188,01/07/2022,18,19085,9763,9322,6343,3119,3224
321,2,97984000,1,114648,2,63574952,01/07/2022,24.9,371387,192530,178857,106784,52432,54352
322,1,19869000,3,20722,1,12894128,01/07/2022,28.2,18023,9240,8783,5154,2503,2651
323,1,14060000,3,44574,1,9094426,01/07/2022,24.8,20322,10479,9843,6201,3025,3176
324,1,19137000,3,30989,1,12408061,01/07/2022,24.8,25477,13300,12177,8208,4059,4149
325,1,8909000,3,43873,1,5746977,01/07/2022,29,13620,7015,6605,4098,1994,2104
326,1,10745000,3,25152,1,6959098,01/07/2022,24.8,48170,25016,23154,15515,7657,7858
327,1,8452000,3,45521,1,5448279,01/07/2022,30.5,10593,5340,5253,3485,1705,1780
328,2,38192000,2,70298,2,24754502,01/07/2022,28.2,8730,4395,4335,2894,1447,1447
329,1,4255000,3,23455,1,2742295,01/07/2022,28.6,14678,7367,7311,4863,2405,2458
330,1,7999000,3,25282,1,5174068,01/07/2022,28.2,10935,5450,5485,3532,1706,1826
331,1,10025000,3,25856,1,6490394,01/07/2022,30.2,19976,10345,9631,6431,3120,3311
332,2,64979000,2,101573,2,42134777,01/07/2022,31.8,412199,209241,202958,82879,40585,42294
333,2,64699000,1,118584,2,41935766,01/07/2022,32,304052,152635,151417,84118,41457,42661
334,2,98261000,1,125853,2,63743797,01/07/2022,29.6,536436,267279,269157,158598,77797,80801
335,3,125889000,1,150201,3,81677649,01/07/2022,29.6,635862,320627,315235,153834,75737,78097
336,3,157582000,1,243779,3,102184521,01/07/2022,30.5,1142952,578172,564780,270109,132170,137939
338,1,16555000,3,34859,1,10725891,01/07/2022,29.6,75721,38037,37684,21903,10795,11108
339,1,20445000,3,37328,1,13251922,01/07/2022,33.1,70378,35870,34508,21367,10464,10903
340,2,47693000,3,26938,2,30973512,01/07/2022,19.1,308285,152976,155309,108145,53196,54949
342,2,46268000,2,58135,2,30016065,01/07/2022,27.9,234698,115478,119220,87040,43098,43942
343,1,13056000,3,26405,1,8459995,01/07/2022,29.6,28843,14318,14525,8529,4190,4339
344,1,12766000,3,23892,1,8274008,01/07/2022,30.1,33522,17126,16396,9330,4711,4619
345,1,15411000,3,46231,1,9970919,01/07/2022,30.6,54467,27606,26861,15858,7789,8069
346,1,17991000,3,19912,1,11674238,01/07/2022,31.8,13059,6525,6534,4137,2073,2064
347,1,1359000,3,4194,1,879156,01/07/2022,19.1,9934,4952,4982,3082,1558,1524
348,1,5495000,3,24321,1,3547429,01/07/2022,19.1,7844,4131,3713,2621,1355,1266
349,1,10155000,3,46932,1,6553818,01/07/2022,29.6,48069,23121,24948,16392,8040,8352
350,1,12370000,3,26073,1,8014427,01/07/2022,32,11583,5810,5773,3713,1872,1841
351,1,3906000,3,22409,1,2516491,01/07/2022,27.4,29903,15539,14364,9778,4798,4980
352,3,138138000,1,248918,3,89540782,01/07/2022,24.5,258913,138803,120110,68042,33683,34359
353,2,53368000,2,82110,2,34607090,01/07/2022,28.1,103609,54904,48705,31555,15575,15980
354,2,30845000,2,72544,2,19976706,01/07/2022,30.3,76660,40113,36547,21596,10646,10950
355,2,37383000,3,45823,2,24253127,01/07/2022,30,88280,46038,42242,25864,12608,13256
356,2,29782000,3,51732,2,19306568,01/07/2022,23.3,56163,29689,26474,18214,8872,9342
357,1,2773000,3,27886,1,1774564,01/07/2022,28.1,7263,3837,3426,2540,1279,1261
358,1,16295000,3,23082,1,10568668,01/07/2022,29,16645,8759,7886,5075,2484,2591
359,1,14904000,3,47621,1,9639979,01/07/2022,27.1,31469,16729,14740,9837,4899,4938
360,1,15486000,3,26002,1,10039898,01/07/2022,17.6,12729,6935,5794,4541,2296,2245
361,1,13849000,3,23493,1,8978357,01/07/2022,30,26015,13735,12280,7360,3633,3727
362,2,41417000,3,33756,2,26887294,01/07/2022,27.4,29903,15539,14364,9778,4798,4980
363,1,26400000,3,35432,1,17124568,01/07/2022,27.8,10504,5405,5099,3440,1722,1718
364,1,18202000,3,23354,1,11807946,01/07/2022,30.4,45134,23442,21692,13494,6690,6804
365,1,23368000,3,31671,1,15157529,01/07/2022,21.2,29130,15431,13699,9957,5019,4938
366,1,4892000,3,19362,1,3160438,01/07/2022,27.7,5812,3105,2707,1767,906,861
367,1,14561000,3,27554,1,9437096,01/07/2022,17.6,15851,8463,7388,5625,2839,2786
368,1,5614000,3,45289,1,3603811,01/07/2022,21.2,15298,8185,7113,4499,2268,2231
369,1,28372000,3,27276,1,18414524,01/07/2022,30,17525,9370,8155,5075,2488,2587
370,1,19972000,2,69202,1,12912598,01/07/2022,17.6,18915,10248,8667,6395,3217,3178
371,1,21198000,3,21010,1,13757690,01/07/2022,22.4,81848,43535,38313,23849,11894,11955
372,2,40673000,3,42045,2,26395405,01/07/2022,22.1,33726,17513,16213,11096,5372,5724
373,1,2733000,3,24163,1,1752287,01/07/2022,21.2,11168,5931,5237,3889,1954,1935
374,1,5905000,3,24581,1,3813669,01/07/2022,28.1,6341,3343,2998,2049,979,1070
375,1,21181000,3,19350,1,13748300,01/07/2022,22.4,45895,23816,22079,12162,5997,6165
376,1,6313000,3,38625,1,4064825,01/07/2022,26.9,6863,3664,3199,2612,1321,1291
377,1,10965000,3,28415,1,7098835,01/07/2022,22.1,10611,5602,5009,3876,1871,2005
378,1,3515000,3,21462,1,2263288,01/07/2022,29,14226,7514,6712,4380,2214,2166
379,1,5413000,3,23454,1,3494996,01/07/2022,22.4,7997,4114,3883,2359,1161,1198
380,1,4049000,3,11094,1,2620756,01/07/2022,27.1,4188,2243,1945,1509,761,748
381,2,30707000,2,55269,2,19904281,01/07/2022,27.4,15373,8115,7258,5203,2638,2565
382,1,18343000,3,30364,1,11892586,01/07/2022,29.1,14071,7408,6663,4497,2251,2246
383,1,1752000,3,20342,1,1118458,01/07/2022,17.6,6642,3720,2922,2058,1005,1053
384,1,6228000,3,6063,1,4042137,01/07/2022,27.8,11054,5638,5416,3563,1745,1818
385,3,217289000,1,453972,3,140783878,01/07/2022,19.9,1542232,806262,735970,402209,198130,204079
386,2,45994000,2,68391,2,29827709,01/07/2022,17.7,78264,40929,37335,23163,11368,11795
387,2,68530000,2,102336,2,44442164,01/07/2022,21.1,293825,155300,138525,93203,46206,46997
388,2,30413000,2,59431,2,19709019,01/07/2022,28.5,49578,26095,23483,16381,8171,8210
389,2,37348000,2,52839,2,24223361,01/07/2022,20.7,89314,47398,41916,25892,12760,13132
390,2,46991000,3,44700,2,30499450,01/07/2022,20,31315,16320,14995,10348,5100,5248
391,1,19619000,3,45354,1,12706996,01/07/2022,15.7,39203,20881,18322,12964,6446,6518
392,1,22022000,3,48413,1,14265887,01/07/2022,20.1,58957,31503,27454,19229,9506,9723
393,2,36482000,2,87607,2,23625693,01/07/2022,17.4,62849,33939,28910,17954,8876,9078
394,1,19911000,3,33435,1,12908715,01/07/2022,16,25468,13582,11886,8293,4136,4157
395,1,24763000,3,48092,1,16047858,01/07/2022,15.7,31599,16595,15004,11708,5967,5741
396,2,31810000,3,31692,2,20644808,01/07/2022,15.7,29123,15247,13876,9589,4733,4856
397,1,17368000,3,23270,1,11265930,01/07/2022,19.7,18110,9443,8667,6325,3046,3279
398,1,13146000,3,44107,1,8500793,01/07/2022,15.7,31695,16422,15273,11280,5582,5698
399,1,16450000,3,34125,1,10658375,01/07/2022,15.7,95322,48884,46438,32521,16133,16388
400,1,16397000,3,23703,1,10634347,01/07/2022,15.7,9358,5013,4345,2738,1323,1415
401,1,12307000,3,50817,1,7948733,01/07/2022,16.1,9149,4948,4201,2691,1357,1334
402,1,3292000,3,21462,1,2118338,01/07/2022,15.7,9913,5282,4631,3496,1711,1785
403,1,10289000,3,12359,1,6675491,01/07/2022,15.7,36620,18819,17801,10303,4961,5342
404,1,2155000,3,21763,1,1378987,01/07/2022,15.7,5276,2719,2557,1830,893,937
405,1,20308000,3,23650,1,13176550,01/07/2022,15.7,41455,21994,19461,13993,6843,7150
406,1,16013000,3,23383,1,10385067,01/07/2022,18.3,29613,15403,14210,9414,4672,4742
408,1,11106000,3,24235,1,7194665,01/07/2022,17.6,13922,7166,6756,5211,2590,2621
409,1,3380000,3,20624,1,2176376,01/07/2022,15.7,10960,5789,5171,3556,1785,1771
410,1,13351000,3,22527,1,8655623,01/07/2022,12.9,22904,12086,10818,7644,3743,3901
411,1,7935000,3,24314,1,5133436,01/07/2022,15.7,11776,6077,5699,3730,1832,1898
412,1,1586000,3,8516,1,1022384,01/07/2022,15.7,16797,8560,8237,5425,2652,2773
413,1,3569000,3,22408,1,2297442,01/07/2022,15.7,19648,10052,9596,6751,3334,3417
414,1,16185000,3,23555,1,10496695,01/07/2022,26.9,19341,10302,9039,6428,3158,3270
415,1,3225000,3,22616,1,2073634,01/07/2022,16.3,11487,6208,5279,3749,1855,1894
416,1,5598000,3,16862,1,3621838,01/07/2022,15.7,5703,2985,2718,1959,971,988
417,1,2171000,3,19746,1,1391404,01/07/2022,15.7,6644,3435,3209,2305,1130,1175
418,1,3436000,3,24077,1,2209323,01/07/2022,15.7,7491,3982,3509,2583,1266,1317
419,1,2181000,3,13808,1,1403842,01/07/2022,15.7,8481,4360,4121,2849,1391,1458
420,1,22175000,3,36251,1,14377499,01/07/2022,19.6,46996,24240,22756,12187,6012,6175
421,1,2944000,3,21930,1,1891670,01/07/2022,22,8445,4468,3977,3005,1505,1500
422,1,6213000,3,22863,1,4015587,01/07/2022,18.1,5612,3027,2585,1851,938,913
423,1,6680000,3,24188,1,4317812,01/07/2022,27.4,5276,2719,2557,1830,893,937
424,3,179578000,1,234657,3,116491043,01/07/2022,21.8,794789,407239,387550,199480,98049,101431
425,2,45652000,2,66095,2,29607705,01/07/2022,18.7,177719,91525,86194,50219,24680,25539
426,1,19823000,3,26012,1,12858938,01/07/2022,18.7,34955,18206,16749,9854,4805,5049
427,1,2382000,3,22961,1,1525339,01/07/2022,18.7,115264,60166,55098,28758,14392,14366
428,1,15169000,3,23124,1,9836726,01/07/2022,18.7,16795,8697,8098,5436,2628,2808
429,1,6867000,3,22961,1,4440589,01/07/2022,23.1,13390,6831,6559,4033,1966,2067
430,1,8630000,3,35739,1,5573761,01/07/2022,23.1,7953,4224,3729,2375,1195,1180
431,1,7355000,3,18233,1,4762517,01/07/2022,27,15512,8121,7391,5093,2493,2600
432,2,55494000,3,51514,2,36019586,01/07/2022,29.3,169028,86790,82238,45879,22689,23190
433,3,161250000,1,170825,3,104641675,01/07/2022,28.7,888797,441181,447616,247410,121384,126026
434,2,73020000,2,72911,2,47390089,01/07/2022,28.8,304942,149380,155562,85665,42398,43267
435,1,26192000,2,72485,1,16952315,01/07/2022,28.7,84519,42292,42227,24955,12440,12515
436,1,15970000,3,32850,1,10347650,01/07/2022,28.6,30754,15948,14806,10320,5221,5099
437,3,134462000,1,164585,3,87235715,01/07/2022,21.6,845941,437370,408571,227808,112567,115241
438,2,56598000,2,62789,2,36725911,01/07/2022,30.7,136351,71718,64633,38918,19062,19856
439,2,29506000,3,34990,2,19143910,01/07/2022,24.5,86686,44901,41785,27406,13467,13939
440,2,30436000,3,46549,2,19736851,01/07/2022,26.7,58158,30570,27588,17715,8934,8781
441,1,26381000,3,47338,1,17100312,01/07/2022,30,24258,12834,11424,7258,3602,3656
442,1,12243000,3,26243,1,7931707,01/07/2022,29.6,24454,12691,11763,7326,3576,3750
443,1,21946000,3,28484,1,14236416,01/07/2022,21.5,310192,159130,151062,94872,46787,48085
444,1,2821000,3,26735,1,1806915,01/07/2022,22.4,14340,7646,6694,4731,2430,2301
445,2,64023000,2,70118,2,41544832,01/07/2022,29.6,15341,8078,7263,4842,2416,2426
446,1,5026000,3,22328,1,3244572,01/07/2022,30,8045,4283,3762,2501,1247,1254
447,1,10735000,3,24365,1,6953385,01/07/2022,30,6644,3540,3104,2086,1058,1028
448,1,3639000,3,21374,1,2343976,01/07/2022,29.6,16582,8647,7935,5030,2477,2553
449,1,24852000,2,79207,1,16074593,01/07/2022,31.7,30796,15740,15056,9239,4503,4736
450,2,60952000,2,88297,2,39530503,01/07/2022,30.9,77849,40866,36983,21990,10871,11119
451,2,34154000,3,46055,2,22154045,01/07/2022,31,65215,33971,31244,19700,9733,9967
452,3,115043000,1,167135,3,74610815,01/07/2022,29.3,441975,227109,214866,122010,60145,61865
453,3,262853000,1,273965,3,170580485,01/07/2022,32.6,808416,416251,392165,234633,115277,119356
454,2,86655000,1,156779,2,56168971,01/07/2022,31.9,298009,154344,143665,83869,41238,42631
455,1,16066000,3,23206,1,10419694,01/07/2022,31.3,33924,17240,16684,10629,5267,5362
456,1,12429000,3,31963,1,8046887,01/07/2022,31.5,14772,7516,7256,4444,2199,2245
457,1,18350000,3,31843,1,11895657,01/07/2022,30.6,19742,9908,9834,6831,3367,3464
458,1,11000000,3,29824,1,7120176,01/07/2022,33,12848,6693,6155,3711,1831,1880
459,1,10499000,3,27478,1,6796872,01/07/2022,29.5,5457,2839,2618,1473,755,718
460,1,6224000,3,27912,1,4017688,01/07/2022,29.6,5926,3043,2883,1700,842,858
461,1,11203000,3,31152,1,7250798,01/07/2022,31.3,17097,8801,8296,5359,2662,2697
462,1,12862000,3,51487,1,8308813,01/07/2022,31.7,28239,14113,14126,8795,4312,4483
463,1,11188000,3,22520,1,7249680,01/07/2022,30.2,16934,8502,8432,5395,2626,2769
464,1,13403000,3,47844,1,8664106,01/07/2022,30.8,11851,5973,5878,3739,1841,1898
465,1,6719000,3,28230,1,4339120,01/07/2022,31.3,25157,12582,12575,8765,4230,4535
466,1,3047000,3,21304,1,1959246,01/07/2022,31.1,6055,3107,2948,1652,803,849
467,1,2990000,3,22151,1,1921349,01/07/2022,31.3,22421,11364,11057,6263,3134,3129
468,1,2065000,3,21733,1,1320517,01/07/2022,30.2,9864,5093,4771,3123,1529,1594
469,1,3030000,3,16725,1,1952775,01/07/2022,30.3,7888,4037,3851,3058,1509,1549
470,1,4448000,3,21806,1,2869394,01/07/2022,29.5,5524,2885,2639,1817,894,923
472,1,2910000,3,23363,1,1868137,01/07/2022,31.9,10328,5288,5040,3690,1794,1896
473,1,1071000,3,21008,1,675142,01/07/2022,30.3,4810,2229,2581,1556,759,797
474,2,80356000,1,162546,2,52068854,01/07/2022,32.3,329404,168547,160857,90108,44605,45503
475,3,153754000,1,285425,3,99654675,01/07/2022,33.2,855563,431621,423942,240318,117646,122672
476,2,31431000,2,77041,2,20353109,01/07/2022,31.6,117253,59414,57839,33098,16300,16798
477,2,62684000,2,63570,2,40681030,01/07/2022,34.1,176685,87738,88947,53884,26504,27380
478,2,68191000,1,120207,2,44203943,01/07/2022,27.5,261137,131158,129979,84004,41439,42565
479,2,37046000,3,50932,2,24028968,01/07/2022,32.2,120926,61958,58968,34805,17098,17707
480,1,25440000,3,38681,1,16497319,01/07/2022,33.3,67604,34141,33463,21101,10330,10771
481,1,12615000,3,22792,1,8176958,01/07/2022,31.7,38886,19733,19153,11641,5731,5910
482,1,15104000,3,24690,1,9792910,01/07/2022,31.3,30324,15540,14784,8298,4088,4210
483,1,26713000,3,41051,1,17322399,01/07/2022,27.4,91029,45722,45307,30379,15003,15376
484,1,24494000,3,31339,1,15889761,01/07/2022,33.8,62301,30877,31424,20494,10127,10367
485,1,2803000,3,21462,1,1800488,01/07/2022,27.8,12987,6460,6527,4296,2156,2140
486,1,14723000,3,25512,1,9544438,01/07/2022,25.3,38113,19225,18888,12385,6138,6247
487,1,2244000,3,21462,1,1437138,01/07/2022,34.2,12372,6340,6032,3845,1851,1994
488,1,12188000,3,29130,1,7893070,01/07/2022,33,39474,19169,20305,14904,7336,7568
489,1,12857000,3,22961,1,8334089,01/07/2022,22.9,30429,15578,14851,9786,4826,4960
490,1,4943000,3,25856,1,3187094,01/07/2022,30.8,13153,6653,6500,4059,2009,2050
491,1,4236000,3,23650,1,2729750,01/07/2022,33.3,11440,5836,5604,4121,2095,2026
492,1,2309000,3,21662,1,1479188,01/07/2022,32.3,4787,2437,2350,1357,684,673
493,3,101745000,1,160683,3,65973567,01/07/2022,28,340060,178122,161938,86078,42456,43622
494,2,49265000,3,41905,2,31980345,01/07/2022,28.9,43035,22773,20262,11996,6054,5942
495,1,22295000,3,34439,1,14457311,01/07/2022,28.8,27182,14325,12857,8434,4220,4214
496,1,16163000,3,22272,1,10483678,01/07/2022,28.9,21003,10909,10094,6452,3209,3243
497,1,23378000,3,39698,1,15156002,01/07/2022,29.7,31435,16316,15119,9125,4445,4680
498,1,17593000,3,27272,1,11408178,01/07/2022,29,29068,15153,13915,8638,4280,4358
499,1,19511000,2,53253,1,12628897,01/07/2022,29.3,25555,13197,12358,7191,3479,3712
500,1,6639000,3,21940,1,4293410,01/07/2022,28,13944,7272,6672,4420,2177,2243
501,1,20287000,3,28631,1,13157919,01/07/2022,28.3,34946,17956,16990,11208,5422,5786
502,1,14602000,3,30357,1,9460943,01/07/2022,29.3,16679,8618,8061,4633,2284,2349
503,2,66660000,2,79203,2,43249797,01/07/2022,29.7,297373,155718,141655,71865,35366,36499
504,3,163860000,1,195383,3,106313617,01/07/2022,29.6,691557,348387,343170,213267,104895,108372
505,2,87660000,2,71916,2,56907084,01/07/2022,33.2,416055,211059,204996,132268,65355,66913
506,1,20595000,3,33837,1,13352913,01/07/2022,30,111314,55902,55412,35576,17423,18153
507,2,71283000,2,93996,2,46239954,01/07/2022,30,332100,171749,160351,94911,46503,48408
508,2,34055000,3,50065,2,22085685,01/07/2022,31.6,79515,41903,37612,21445,10720,10725
509,2,33424000,2,56270,2,21669330,01/07/2022,29.1,205933,107685,98248,49242,24249,24993
510,1,15174000,3,22272,1,9840828,01/07/2022,32.3,48172,24667,23505,15031,7399,7632
511,1,9828000,3,25035,1,6363165,01/07/2022,30,18592,8945,9647,4116,2046,2070
512,2,32743000,3,35426,2,21247524,01/07/2022,29.9,79824,40689,39135,24808,12213,12595
513,1,2395000,3,19877,1,1536873,01/07/2022,30,10327,5388,4939,2996,1506,1490
514,1,8449000,3,19431,1,5472419,01/07/2022,30,28215,14347,13868,9384,4582,4802
515,1,5740000,3,6152,1,3724848,01/07/2022,30.2,10993,5737,5256,3544,1803,1741
517,1,27185000,3,37258,1,17632992,01/07/2022,15.4,53373,27810,25563,15744,7755,7989
518,2,33704000,2,78260,2,21829340,01/07/2022,18.6,13555,7357,6198,3051,1547,1504
519,1,28521000,3,35829,1,18502821,01/07/2022,15.5,59871,31271,28600,19112,9469,9643
520,2,46870000,2,73622,2,30391878,01/07/2022,17.6,47632,25410,22222,12563,6265,6298
521,1,19350000,3,31255,1,12546245,01/07/2022,18.4,45587,23716,21871,14000,6913,7087
522,1,14539000,3,23574,1,9426776,01/07/2022,15.8,37704,19683,18021,12453,6131,6322
523,1,13801000,3,18423,1,8952227,01/07/2022,15.4,70224,35655,34569,24421,12033,12388
524,1,3594000,3,40931,1,2295169,01/07/2022,15.4,17978,9382,8596,6248,3105,3143
525,1,1700000,3,23983,1,1081017,01/07/2022,15.4,13401,6929,6472,4288,2149,2139
526,1,1460000,3,15777,1,933223,01/07/2022,15.4,30417,15670,14747,9405,4719,4686
527,1,6931000,3,29409,1,4475741,01/07/2022,15.4,28657,14853,13804,9078,4552,4526
528,1,1369000,3,11207,1,878643,01/07/2022,15.4,1583,826,757,480,230,250
529,2,56254000,2,91375,2,36473725,01/07/2022,23.8,139075,74465,64610,36819,18286,18533
530,2,60327000,1,107181,2,39105369,01/07/2022,22,120500,65043,55457,29046,14403,14643
531,2,69166000,2,52320,2,44905580,01/07/2022,28,101336,54039,47297,24763,12096,12667
532,3,145424000,1,314397,3,94211203,01/07/2022,28.5,405952,215818,190134,89205,43880,45325
533,2,59751000,1,123783,2,38714367,01/07/2022,28.2,212540,111746,100794,51580,25268,26312
534,2,65649000,1,127614,2,42544236,01/07/2022,29.4,180057,96347,83710,45301,22589,22712
535,2,74271000,1,216923,2,48059227,01/07/2022,21.2,443063,237967,205096,110147,54509,55638
536,1,27231000,3,23514,1,17676636,01/07/2022,28.4,33226,17650,15576,10241,5095,5146
537,1,10152000,3,24702,1,6574098,01/07/2022,28.2,15512,8193,7319,4859,2440,2419
538,2,41060000,2,57829,2,26631171,01/07/2022,27,64445,34215,30230,17692,8626,9066
539,2,37537000,3,34413,2,24364637,01/07/2022,28.6,48567,25769,22798,13570,6693,6877
540,1,24165000,3,24288,1,15682962,01/07/2022,14.8,42451,22342,20109,14824,7241,7583
541,1,18526000,3,27300,1,12014600,01/07/2022,29.8,41588,21739,19849,12522,6161,6361
543,1,26361000,3,48865,1,17085785,01/07/2022,29.4,55452,29697,25755,14940,7380,7560
544,1,1836000,3,20509,1,1172891,01/07/2022,28.5,6076,3180,2896,1703,844,859
545,2,43341000,2,61869,2,28109781,01/07/2022,29.4,64692,34002,30690,19678,9778,9900
546,1,4420000,3,26577,1,2846423,01/07/2022,27.8,22760,12125,10635,6420,3229,3191
547,1,17010000,3,33779,1,11022721,01/07/2022,29.5,25608,13480,12128,7723,3870,3853
548,1,12443000,3,50135,1,8037815,01/07/2022,27,15733,8506,7227,4079,2054,2025
549,1,7565000,3,25391,1,4891859,01/07/2022,22,41785,22480,19305,10854,5445,5409
550,1,10972000,3,32136,1,7099664,01/07/2022,27.7,13225,6946,6279,3476,1669,1807
551,1,16052000,3,35829,1,10397971,01/07/2022,21.6,28655,15243,13412,8764,4302,4462
552,1,7001000,3,33936,1,4516714,01/07/2022,26.6,17727,9423,8304,4199,2068,2131
553,1,14608000,2,88795,1,9406405,01/07/2022,28.2,8969,4883,4086,2821,1444,1377
554,1,12396000,3,23161,1,8034239,01/07/2022,29,16758,8967,7791,4993,2542,2451
555,2,37247000,3,44865,2,24165685,01/07/2022,27.7,47035,25085,21950,12872,6289,6583
556,1,19781000,3,31239,1,12826411,01/07/2022,27.5,55720,29557,26163,14521,7123,7398
557,1,21847000,3,27276,1,14173274,01/07/2022,26.4,46909,24866,22043,15156,7483,7673
558,1,13412000,3,28175,1,8689625,01/07/2022,26.4,33986,17827,16159,9043,4421,4622
559,1,12955000,3,33492,1,8387258,01/07/2022,22,34847,18666,16181,8943,4380,4563
560,1,14186000,3,36130,1,9184770,01/07/2022,27.6,14304,7545,6759,4455,2182,2273
561,1,9376000,3,27011,1,6067389,01/07/2022,27.7,20797,10995,9802,4991,2418,2573
562,1,18048000,3,33009,1,11698191,01/07/2022,27.8,30232,15727,14505,8913,4281,4632
563,1,26272000,2,55429,1,17021371,01/07/2022,28,20165,10621,9544,5395,2701,2694
564,1,2976000,3,19479,1,1914921,01/07/2022,29.4,20380,10692,9688,6259,3127,3132
565,1,11659000,3,26744,1,7551606,01/07/2022,16.2,21640,11976,9664,7433,3885,3548
566,1,20695000,3,33795,1,13417955,01/07/2022,18,33402,17876,15526,9753,4761,4992
567,1,24371000,3,43886,1,15797264,01/07/2022,27.5,26236,13620,12616,8067,3962,4105
568,1,3476000,3,21036,1,2238364,01/07/2022,26.5,4405,2358,2047,1451,735,716
569,1,4075000,3,22272,1,2626478,01/07/2022,26.9,13716,7109,6607,3981,1920,2061
570,1,14117000,3,26322,1,9149728,01/07/2022,27.6,5653,2987,2666,1709,826,883
571,1,11405000,3,33680,1,7379570,01/07/2022,28.8,21318,11472,9846,5688,2873,2815
572,1,12024000,3,22704,1,7792896,01/07/2022,27.6,14582,7621,6961,4539,2262,2277
573,1,1673000,3,28532,1,1058918,01/07/2022,28.3,6219,3311,2908,1883,941,942
574,1,9889000,3,32348,1,6395502,01/07/2022,27.7,31856,17018,14838,8563,4318,4245
575,1,16840000,3,22505,1,10923495,01/07/2022,22,35893,18883,17010,11399,5600,5799
576,1,18380000,3,29222,1,11917778,01/07/2022,28.8,19272,10328,8944,5163,2534,2629
577,1,17320000,3,28695,1,11229305,01/07/2022,15,16364,8711,7653,5250,2654,2596
578,1,11212000,3,29379,1,7258421,01/07/2022,28.5,2820,1449,1371,720,341,379
579,1,2616000,3,20348,1,1680052,01/07/2022,28.4,4654,2510,2144,1296,630,666
580,1,1665000,3,21763,1,1060487,01/07/2022,15,21585,11243,10342,6456,3197,3259
581,1,1758000,3,22272,1,1120428,01/07/2022,27.6,6888,3543,3345,1840,922,918
582,1,2111000,3,24503,1,1347647,01/07/2022,27.9,21391,11404,9987,5619,2742,2877
583,1,1263000,3,22398,1,798552,01/07/2022,27.8,9668,5030,4638,2384,1141,1243
584,1,19223000,3,24347,1,12470603,01/07/2022,27.7,13995,7311,6684,4212,2070,2142
585,1,5295000,3,22408,1,3419342,01/07/2022,27.5,6838,3583,3255,1791,891,900
586,1,1622000,3,21666,1,1032634,01/07/2022,27.9,5681,3058,2623,1606,823,783
587,1,9938000,3,25716,1,6433984,01/07/2022,15,13966,7679,6287,3739,1859,1880
588,1,13181000,3,19171,1,8548479,01/07/2022,28.2,28076,14773,13303,7550,3752,3798
589,1,6441000,3,27484,1,4159166,01/07/2022,14.2,34039,18008,16031,8858,4334,4524
590,1,1890000,3,18812,1,1209688,01/07/2022,22,15807,8231,7576,5949,2955,2994
591,1,1194000,3,14015,1,762085,01/07/2022,27.5,10581,5508,5073,2907,1418,1489
592,1,3518000,3,24581,1,2262119,01/07/2022,19.2,9554,4935,4619,2707,1302,1405
593,1,13616000,2,75370,1,8775030,01/07/2022,26.4,9988,5342,4646,2237,1127,1110
594,1,2777000,3,13937,1,1791113,01/07/2022,29.2,7578,3984,3594,2088,1031,1057
595,1,2812000,3,22616,1,1805184,01/07/2022,20.1,8005,4106,3899,2599,1296,1303
596,1,3316000,3,21502,1,2133898,01/07/2022,28.2,24085,12288,11797,7909,3780,4129
597,1,4375000,3,22013,1,2821737,01/07/2022,27.9,7455,4054,3401,2223,1145,1078
598,1,1086000,3,8433,1,697467,01/07/2022,28.3,17919,9538,8381,4548,2298,2250
599,1,5497000,3,24059,1,3548991,01/07/2022,29.4,15305,8066,7239,4706,2332,2374
600,3,143893000,1,231751,3,93298699,01/07/2022,29.7,921771,479309,442462,222551,109790,112761
601,1,14516000,3,21586,1,9413814,01/07/2022,26.5,26081,13338,12743,7626,3791,3835
602,2,30212000,3,20755,2,19617045,01/07/2022,29.5,56494,29131,27363,17460,8617,8843
603,1,18734000,3,23082,1,12154018,01/07/2022,28.6,52593,26982,25611,16883,8307,8576
604,1,6086000,3,29547,1,3926353,01/07/2022,27.8,41965,21110,20855,11192,5453,5739
605,1,9275000,3,27696,1,6001054,01/07/2022,28.9,26175,13553,12622,8885,4301,4584
606,1,12799000,3,26437,1,8292913,01/07/2022,28.2,35183,17868,17315,10650,5230,5420
607,1,9722000,3,26187,1,6293113,01/07/2022,27.3,56409,28489,27920,16919,8292,8627
608,1,8766000,3,13893,1,5684007,01/07/2022,28.9,139753,70456,69297,45077,22298,22779
609,1,8216000,3,23030,1,5317370,01/07/2022,28,17841,9042,8799,5372,2677,2695
610,1,7522000,3,20440,1,4868860,01/07/2022,28.9,28461,14574,13887,9148,4533,4615
611,2,40655000,2,62223,2,26363527,01/07/2022,21.7,143281,73905,69376,47529,23519,24010
612,2,42600000,2,104913,2,27585087,01/07/2022,16.7,138444,72335,66109,38201,18773,19428
613,1,13289000,3,23998,1,8613852,01/07/2022,22.1,22295,11690,10605,8176,4115,4061
614,1,14791000,3,46470,1,9567680,01/07/2022,20.3,25068,12776,12292,8673,4237,4436
615,1,3416000,3,22441,1,2197959,01/07/2022,21.5,15291,7886,7405,5051,2477,2574
616,1,5231000,3,22151,1,3377999,01/07/2022,21.1,38193,19467,18726,13775,6896,6879
617,1,10844000,3,23286,1,7025314,01/07/2022,22.5,46132,23831,22301,13972,6871,7101
618,1,2145000,3,21462,1,1372788,01/07/2022,24.1,13641,7027,6614,4307,2133,2174
1,2,96025000,1,174536,2,62241714,01/06/2022,24.1,863893,444725,419168,260350,128225,132125
2,1,16479000,3,24834,1,10686516,01/06/2022,24.6,31963,16433,15530,11390,5609,5781
3,1,10310000,3,22023,1,6679477,01/06/2022,22.7,63805,32406,31399,23397,11652,11745
4,1,8515000,3,22383,1,5512367,01/06/2022,24.6,21049,10874,10175,7097,3529,3568
5,1,4962000,3,20491,1,3204809,01/06/2022,22.2,32035,16367,15668,10989,5374,5615
6,3,200214000,1,235157,3,129903943,01/06/2022,34.9,854186,425977,428209,227917,112151,115766
7,3,387350000,1,506629,3,251270871,01/06/2022,20.7,1810645,899293,911352,503963,246971,256992
8,2,83828000,2,90895,2,54397305,01/06/2022,22.4,330652,167339,163313,86895,42903,43992
9,2,34527000,3,26024,2,22416526,01/06/2022,24,81059,40420,40639,23492,11470,12022
10,2,32190000,3,48206,2,20875294,01/06/2022,21,100660,49935,50725,28067,13772,14295
11,1,18206000,3,25298,1,11808602,01/06/2022,33,19081,9476,9605,5934,2909,3025
12,2,67766000,1,116661,2,43931239,01/06/2022,29.8,250141,126245,123896,65670,32312,33358
13,2,49291000,2,78245,2,31960905,01/06/2022,25,136285,66083,70202,42780,21001,21779
14,2,69144000,1,105933,2,44837667,01/06/2022,26.4,202694,98608,104086,64935,31858,33077
15,1,22301000,3,32396,1,14463254,01/06/2022,26.4,43805,22160,21645,13050,6507,6543
16,1,23508000,2,65687,1,15214513,01/06/2022,29.7,16311,8010,8301,4984,2435,2549
17,1,8602000,3,24163,1,5567137,01/06/2022,27.9,14357,6822,7535,3854,1925,1929
18,1,2535000,3,26801,1,1620949,01/06/2022,20,13596,6842,6754,4196,2086,2110
19,1,8101000,3,24132,1,5241518,01/06/2022,24.6,13596,6842,6754,4196,2086,2110
20,1,2759000,3,28344,1,1765006,01/06/2022,22.3,7185,3509,3676,2099,1015,1084
21,2,39033000,2,63103,2,25308347,01/06/2022,28.5,191238,97313,93925,52600,25862,26738
22,2,36965000,2,58104,2,23969146,01/06/2022,28.8,249623,130524,119099,66498,32635,33863
23,1,23179000,3,23470,1,15042880,01/06/2022,29.1,31375,16375,15000,10682,5317,5365
24,1,16595000,3,25598,1,10761152,01/06/2022,28.6,35799,18291,17508,11962,5883,6079
25,1,9378000,3,31251,1,6064449,01/06/2022,28.6,15949,8217,7732,4538,2234,2304
26,2,72134000,2,85038,2,46802062,01/06/2022,28.1,217550,113613,103937,65123,32048,33075
27,2,42339000,3,42189,2,27478161,01/06/2022,18.4,183509,96930,86579,60413,30246,30167
28,2,46709000,2,68926,2,30291924,01/06/2022,20.2,113479,60064,53415,36594,18199,18395
29,2,91829000,2,82931,2,59605919,01/06/2022,26.4,578830,303756,275074,166456,82025,84431
30,2,33178000,3,43872,2,21521828,01/06/2022,28.1,51797,27093,24704,17614,8812,8802
31,2,55614000,1,124008,2,36025092,01/06/2022,26.4,38087,20017,18070,11916,5833,6083
32,1,11128000,3,20774,1,7212426,01/06/2022,28.8,32109,16780,15329,10495,5074,5421
33,1,22643000,3,21392,1,14696558,01/06/2022,23.9,21727,11415,10312,7786,3890,3896
34,1,14932000,3,26755,1,9679045,01/06/2022,26.3,49201,25651,23550,16539,8102,8437
35,1,21373000,3,35287,1,13857163,01/06/2022,25.4,37546,19668,17878,11791,5836,5955
36,1,20477000,2,74876,1,13235174,01/06/2022,19.6,47688,25247,22441,17870,8920,8950
37,1,4666000,3,22024,1,3010876,01/06/2022,27.9,55931,28786,27145,18430,9082,9348
38,1,10477000,3,31293,1,6778757,01/06/2022,24.2,29018,15064,13954,10291,5191,5100
39,1,9242000,3,36957,1,5970343,01/06/2022,25.2,18219,9592,8627,5806,2838,2968
40,1,11674000,3,25108,1,7562992,01/06/2022,28.2,15244,8058,7186,4848,2429,2419
41,1,4862000,3,21085,1,3139215,01/06/2022,31,25366,13345,12021,7752,3823,3929
42,1,15805000,3,22179,1,10251071,01/06/2022,26.5,19271,9996,9275,6517,3095,3422
43,1,4198000,3,19498,1,2709202,01/06/2022,27.5,7662,4073,3589,2321,1153,1168
45,3,303302000,1,258273,3,196888027,01/06/2022,29.7,1501551,750157,751394,459910,225614,234296
46,3,110757000,1,182895,3,71809155,01/06/2022,28.1,925762,474776,450986,250961,123448,127513
47,2,31378000,3,50852,2,20344848,01/06/2022,30.5,128548,65838,62710,37721,18411,19310
48,1,26812000,3,42016,1,17385784,01/06/2022,23.1,135586,69677,65909,41627,20458,21169
49,2,33369000,2,60440,2,21629410,01/06/2022,26,113843,59214,54629,34117,16974,17143
50,1,5870000,3,26130,1,3789370,01/06/2022,32,23140,11693,11447,7155,3499,3656
51,1,9420000,3,23278,1,6099722,01/06/2022,27.4,35087,17902,17185,11563,5663,5900
52,1,12991000,3,31862,1,8412288,01/06/2022,28.9,42019,21548,20471,12599,6234,6365
53,1,9987000,3,29679,1,6461871,01/06/2022,33.5,22066,11231,10835,6719,3420,3299
54,1,8729000,3,22779,1,5651071,01/06/2022,18,17410,9121,8289,6393,3204,3189
55,1,2172000,3,21292,1,1390508,01/06/2022,29.1,22568,11549,11019,7200,3540,3660
56,1,6691000,3,22102,1,4327048,01/06/2022,23.6,15054,7516,7538,5557,2768,2789
57,1,3880000,2,69254,1,2452746,01/06/2022,26.9,8253,4210,4043,2801,1419,1382
58,1,5134000,3,21033,1,3316067,01/06/2022,22.2,7834,4065,3769,2439,1200,1239
59,1,2097000,3,21237,1,1341813,01/06/2022,18.1,14755,7617,7138,4907,2427,2480
60,1,12202000,3,33527,1,7897773,01/06/2022,26.1,62038,31762,30276,19262,9511,9751
61,3,100404000,1,122161,3,65140439,01/06/2022,30.7,690193,353744,336449,203574,99881,103693
62,3,135509000,1,177141,3,87903709,01/06/2022,23.9,864431,434753,429678,267728,131619,136109
63,2,44376000,2,79934,2,28764466,01/06/2022,32.7,237169,119538,117631,71348,35023,36325
64,2,51143000,2,65129,2,33177821,01/06/2022,31.2,173959,86825,87134,55826,27459,28367
65,1,10597000,3,23385,1,6864665,01/06/2022,31.3,39058,19755,19303,11201,5479,5722
66,3,112094000,1,160707,3,72700393,01/06/2022,29.5,59762,30506,29256,20025,9931,10094
67,1,15477000,3,35635,1,10024415,01/06/2022,31.1,49490,25496,23994,16916,8460,8456
68,2,30234000,2,53406,2,19598694,01/06/2022,31.4,160225,79799,80426,53549,26489,27060
69,1,17139000,3,20853,1,11119497,01/06/2022,24.9,114010,56192,57818,38156,18905,19251
70,1,25333000,3,36420,1,16430030,01/06/2022,30.1,75242,37695,37547,23792,11778,12014
71,1,12978000,3,22547,1,8413153,01/06/2022,32.5,59196,29915,29281,18125,8949,9176
72,1,16014000,3,23972,1,10385128,01/06/2022,30,32704,16713,15991,11320,5572,5748
73,1,7133000,3,24532,1,4611918,01/06/2022,31.3,23413,11884,11529,7157,3552,3605
74,1,9796000,3,24592,1,6342808,01/06/2022,30.8,38992,19602,19390,13022,6299,6723
75,1,1727000,3,27717,1,1094833,01/06/2022,31.8,27314,13703,13611,9005,4397,4608
76,2,54129000,2,68954,2,35114896,01/06/2022,26.3,146965,75962,71003,46271,22786,23485
77,1,28160000,3,41304,1,18262696,01/06/2022,30.3,88337,44762,43575,34686,17254,17432
78,2,41301000,2,66278,2,26779372,01/06/2022,28.9,159853,80569,79284,57402,28064,29338
79,1,2659000,3,21215,1,1707135,01/06/2022,26.2,9746,4912,4834,3336,1602,1734
80,1,1965000,3,25815,1,1251435,01/06/2022,29.3,15368,7632,7736,5699,2779,2920
81,1,1179000,3,7831,1,758519,01/06/2022,28.3,147496,76348,71148,49524,24280,25244
82,1,1186000,3,22642,1,748258,01/06/2022,27.7,14892,7420,7472,5365,2615,2750
83,1,8056000,3,24006,1,5212394,01/06/2022,30.3,34798,17459,17339,10865,5211,5654
84,2,35229000,1,179092,2,22719758,01/06/2022,19.8,432205,227255,204950,86717,42372,44345
85,2,39185000,1,179185,2,25291065,01/06/2022,19.8,759003,398068,360935,168014,83097,84917
86,2,88148000,1,332591,2,56963609,01/06/2022,19.9,1173351,609477,563874,261635,129105,132530
87,1,25039000,2,62605,1,16212745,01/06/2022,20,414470,219003,195467,75588,37198,38390
88,1,16434000,2,57875,1,10624225,01/06/2022,18.4,186693,97615,89078,46165,22603,23562
89,3,149798000,1,374905,3,96993795,01/06/2022,20.2,1835486,947835,887651,451632,222341,229291
90,2,47469000,1,120417,2,30734433,01/06/2022,19.7,614447,325337,289110,113945,55951,57994
91,1,24212000,2,91096,1,15646704,01/06/2022,19.5,434153,232032,202121,62030,30612,31418
92,2,50231000,1,134702,2,32515448,01/06/2022,19,323771,167274,156497,83659,40990,42669
93,2,41326000,2,100811,2,26761089,01/06/2022,18.4,404695,212343,192352,85496,42058,43438
94,1,23567000,1,154646,1,15163904,01/06/2022,22,443704,233586,210118,95713,47173,48540
95,2,56817000,1,255296,2,36675754,01/06/2022,19.4,545884,284933,260951,101794,50260,51534
96,1,14422000,2,59192,1,9315108,01/06/2022,18.4,429481,220393,209088,105785,52018,53767
97,1,8474000,3,44274,1,5463826,01/06/2022,15.1,246428,128767,117661,58169,28791,29378
98,1,11435000,3,35381,1,7397369,01/06/2022,15.1,599935,314284,285651,130174,64060,66114
99,3,119456000,1,150457,3,77495943,01/06/2022,24.3,616068,317266,298802,191866,94056,97810
100,2,72396000,2,94963,2,46962437,01/06/2022,24,301742,154079,147663,97495,48007,49488
101,1,10249000,3,17412,1,6644438,01/06/2022,28.5,96243,49040,47203,29383,14345,15038
102,1,17572000,3,33591,1,11388209,01/06/2022,24.3,30063,15334,14729,10450,5151,5299
103,1,1431000,2,91399,1,838751,01/06/2022,29.5,3222,1654,1568,1247,637,610
104,1,12937000,2,56466,1,8352584,01/06/2022,22.4,17967,9205,8762,6003,2945,3058
105,1,2355000,3,19820,1,1510930,01/06/2022,23.5,11943,6311,5632,3854,1993,1861
106,1,2078000,2,98213,1,1252487,01/06/2022,27.7,12850,6538,6312,4678,2267,2411
107,2,36235000,1,105148,2,23447602,01/06/2022,15.7,26678,13733,12945,10032,4897,5135
108,3,155480000,1,255446,3,100806554,01/06/2022,16.2,223876,119352,104524,50306,24928,25378
109,2,56403000,1,186075,2,36475875,01/06/2022,17.4,515353,266081,249272,126007,61695,64312
110,2,90137000,1,319726,2,58269324,01/06/2022,17.6,776220,402522,373698,193769,95439,98330
111,2,55382000,2,91858,2,35906442,01/06/2022,17.2,84298,43745,40553,23019,11356,11663
112,2,42821000,2,52448,2,27781202,01/06/2022,18.2,30929,15848,15081,8319,4034,4285
113,2,29334000,1,131957,2,18935143,01/06/2022,17.8,293245,152241,141004,70657,34731,35926
114,2,53859000,1,202570,2,34805780,01/06/2022,17.2,658907,338453,320454,150053,73914,76139
115,1,23628000,3,29675,1,15328525,01/06/2022,17.2,117995,60165,57830,29983,14851,15132
116,3,151969000,1,339602,3,98440248,01/06/2022,16.2,1643623,845932,797691,437489,216020,221469
117,2,67392000,1,157466,2,43647334,01/06/2022,21.2,368585,190133,178452,107535,52900,54635
118,2,41649000,2,69416,2,27002434,01/06/2022,9.1,174704,91497,83207,54449,28355,26094
119,1,17424000,3,43924,1,11281676,01/06/2022,6.7,2931,1520,1411,975,512,463
120,2,50477000,1,110073,2,32699977,01/06/2022,10,35491,18986,16505,7987,3993,3994
121,2,59450000,1,152474,2,38490026,01/06/2022,17.2,703215,359601,343614,230612,113552,117060
122,2,55755000,1,177693,2,36063057,01/06/2022,18.6,18226,9300,8926,5308,2603,2705
123,2,45621000,2,78133,2,29575517,01/06/2022,19.4,1072676,556998,515678,265425,131078,134347
124,1,20246000,3,23083,1,13136817,01/06/2022,21.8,14038,7254,6784,3763,1910,1853
125,2,62079000,2,96004,2,40255346,01/06/2022,9.1,174704,91497,83207,54449,28355,26094
126,2,47459000,3,37465,2,30810885,01/06/2022,15.9,7077,3593,3484,1748,893,855
127,2,32602000,3,51406,2,21139894,01/06/2022,16.2,53362,27304,26058,15169,7515,7654
128,1,14683000,3,20550,1,9523400,01/06/2022,5.5,24612,12254,12358,7339,3541,3798
129,2,45275000,1,167193,2,29261557,01/06/2022,18.9,10873,5623,5250,3757,1878,1879
130,2,49393000,2,58837,2,32046613,01/06/2022,15.3,23219,12339,10880,6425,3186,3239
131,1,22993000,3,33453,1,14911997,01/06/2022,19.2,12671,6512,6159,3454,1710,1744
132,1,18568000,3,30164,1,12039036,01/06/2022,15.9,30967,16277,14690,10756,5327,5429
133,2,34968000,3,50569,2,22678631,01/06/2022,19.2,323545,166328,157217,93932,46757,47175
134,1,6237000,3,22915,1,4031135,01/06/2022,23.5,19326,10155,9171,6252,3129,3123
135,1,17496000,3,34156,1,11338244,01/06/2022,9.1,33716,17686,16030,9317,4624,4693
136,1,11755000,2,56168,1,7584582,01/06/2022,16.9,40279,20716,19563,10282,5078,5204
137,1,3679000,3,20061,1,2371289,01/06/2022,18.9,29068,14916,14152,8580,4220,4360
138,1,25565000,2,54467,1,16562783,01/06/2022,18.7,12752,6694,6058,3471,1768,1703
139,1,4260000,3,45190,1,2723810,01/06/2022,15.9,33166,16973,16193,9497,4707,4790
140,1,6191000,3,14374,1,4009776,01/06/2022,17.2,52828,27143,25685,16500,8128,8372
141,1,27410000,3,25901,1,17790599,01/06/2022,17,32738,16941,15797,9059,4431,4628
142,1,9100000,3,23400,1,5891600,01/06/2022,18.9,30203,15792,14411,7568,3777,3791
143,1,28360000,3,33617,1,18400383,01/06/2022,17.2,11760,6069,5691,3432,1700,1732
144,1,9326000,3,23122,1,6038778,01/06/2022,19.4,72525,37076,35449,22128,10944,11184
145,1,7446000,3,25318,1,4814582,01/06/2022,6.7,18580,9729,8851,5724,2801,2923
146,1,17323000,3,28722,1,11231228,01/06/2022,18.6,24575,12798,11777,7126,3453,3673
147,1,1317000,3,21773,1,834277,01/06/2022,17.8,44731,22925,21806,13335,6514,6821
148,1,7101000,3,50013,1,4565637,01/06/2022,16.5,658907,338453,320454,150053,73914,76139
149,1,12836000,3,24435,1,8318965,01/06/2022,17.2,10336,5387,4949,3449,1664,1785
150,1,10011000,3,22384,1,6484766,01/06/2022,14.5,4656,2421,2235,1533,751,782
151,1,6069000,3,26573,1,3918277,01/06/2022,19.2,9598,5002,4596,2910,1467,1443
152,1,9680000,3,25171,1,6266829,01/06/2022,17.2,15171,7853,7318,4470,2251,2219
153,1,6110000,3,26602,1,3944898,01/06/2022,18.9,10792,5577,5215,3492,1713,1779
154,1,1807000,3,2553,1,1171997,01/06/2022,17.2,37442,19141,18301,12089,5963,6126
155,1,3335000,3,21853,1,2145897,01/06/2022,9.1,17736,9182,8554,5577,2775,2802
156,1,7968000,3,11767,1,5167433,01/06/2022,18.6,386290,199249,187041,112223,55337,56886
157,1,7969000,3,28533,1,5151317,01/06/2022,18.6,9925,5218,4707,2833,1403,1430
158,1,7745000,3,22912,1,5011338,01/06/2022,21.8,6944,3666,3278,2341,1149,1192
159,1,6383000,3,28375,1,4120575,01/06/2022,16.2,88734,45471,43263,28316,14166,14150
160,1,7722000,3,25978,1,4993322,01/06/2022,10,6449,3346,3103,1687,833,854
161,1,5400000,3,27587,1,3482413,01/06/2022,15.5,10735,5576,5159,3010,1518,1492
162,1,2790000,3,21579,1,1791921,01/06/2022,10,10810,5614,5196,2941,1451,1490
163,1,1102000,3,956,1,715344,01/06/2022,28.2,13038,6614,6424,4157,2015,2142
165,3,163765000,1,222875,3,106224375,01/06/2022,23.8,1579803,804212,775591,594938,292494,302444
166,2,73021000,2,62884,2,47400766,01/06/2022,21.2,378143,194849,183294,128863,62806,66057
167,2,66155000,2,63931,2,42936819,01/06/2022,23.6,452090,230346,221744,162764,80177,82587
168,1,21032000,3,30846,1,13639954,01/06/2022,24.1,69371,35473,33898,25304,12303,13001
169,1,27874000,3,44439,1,18073661,01/06/2022,22.2,79772,40908,38864,30907,15312,15595
170,1,21814000,3,34128,1,14144972,01/06/2022,21.9,56597,29703,26894,19146,9514,9632
171,1,22173000,3,31430,1,14381020,01/06/2022,22,72663,38036,34627,27395,13712,13683
172,2,43279000,2,76921,2,28054429,01/06/2022,23.3,160682,83178,77504,52342,25860,26482
173,1,27732000,3,38163,1,17987637,01/06/2022,22.5,83352,42766,40586,32937,16375,16562
174,1,27369000,3,29590,1,17760260,01/06/2022,20.3,67101,35567,31534,27008,13393,13615
175,1,15525000,3,32435,1,10058815,01/06/2022,21.8,43249,22352,20897,17065,8284,8781
176,1,22790000,3,43630,1,14769870,01/06/2022,21,51894,27702,24192,20579,10113,10466
177,1,21253000,3,47677,1,13766773,01/06/2022,22.8,70068,36526,33542,21044,10402,10642
178,1,18024000,3,24105,1,11691495,01/06/2022,22.3,52156,27081,25075,17108,8394,8714
179,1,3303000,3,26755,1,2120195,01/06/2022,20.5,41910,21741,20169,12631,6146,6485
180,1,20300000,3,47978,1,13147022,01/06/2022,21.4,43998,23109,20889,17575,8775,8800
181,1,5302000,3,21578,1,3424722,01/06/2022,24.9,24757,12827,11930,9816,4898,4918
182,1,3501000,3,21936,1,2253714,01/06/2022,21.4,21756,11234,10522,8659,4317,4342
183,1,7909000,3,13647,1,5127203,01/06/2022,21.4,28109,14419,13690,10548,5187,5361
184,1,5667000,3,24066,1,3659484,01/06/2022,24.3,15305,7996,7309,5899,2872,3027
185,1,22489000,2,61212,1,14556638,01/06/2022,20.5,72452,38019,34433,23628,11618,12010
186,1,15630000,3,23293,1,10136207,01/06/2022,22,35401,18444,16957,12235,5945,6290
187,1,22174000,3,35450,1,14377650,01/06/2022,21.8,27593,14289,13304,10803,5260,5543
188,1,17830000,3,21636,1,11567864,01/06/2022,22.3,31264,16171,15093,9806,4840,4966
189,1,16054000,3,40238,1,10394862,01/06/2022,18.3,24228,12861,11367,9383,4674,4709
190,1,18659000,3,28508,1,12099842,01/06/2022,18,32831,17049,15782,13856,6706,7150
191,1,2826000,3,27150,1,1809750,01/06/2022,23.3,16092,8507,7585,6837,3451,3386
192,1,7092000,3,27590,1,4582210,01/06/2022,20.4,8011,4268,3743,3134,1562,1572
193,1,12633000,3,29384,1,8182066,01/06/2022,24.1,29002,14796,14206,11206,5550,5656
194,1,2497000,3,27408,1,1595642,01/06/2022,18.8,7946,4172,3774,3293,1607,1686
195,1,10505000,3,10738,1,6817512,01/06/2022,22.8,28260,14728,13532,11002,5473,5529
196,1,5567000,3,6425,1,3612125,01/06/2022,22.1,25845,13471,12374,9370,4627,4743
197,3,123995000,1,203470,3,80393280,01/06/2022,28.4,658609,345979,312630,183298,90145,93153
198,2,47752000,2,55261,2,30983539,01/06/2022,22.9,225728,119129,106599,71494,35347,36147
199,2,29908000,3,41070,2,19399130,01/06/2022,31.3,70760,36613,34147,21788,10705,11083
200,2,38539000,2,77655,2,24972695,01/06/2022,26.8,132854,69610,63244,41183,20301,20882
201,1,16538000,2,70958,1,10678742,01/06/2022,20.7,50399,26542,23857,14000,6918,7082
202,1,2707000,3,27316,1,1732234,01/06/2022,23.5,27944,14419,13525,9490,4664,4826
203,1,5405000,3,25417,1,3487833,01/06/2022,21.2,22534,11802,10732,7926,3939,3987
204,1,12470000,3,29316,1,8076184,01/06/2022,27.3,25148,13436,11712,8928,4476,4452
205,1,22679000,3,27599,1,14713751,01/06/2022,22,33783,18241,15542,12201,6089,6112
206,2,29576000,3,26154,2,19198246,01/06/2022,28.7,25850,13268,12582,8390,4048,4342
208,2,32366000,3,41824,2,20996076,01/06/2022,20.1,27607,14605,13002,9883,5002,4881
209,1,8733000,3,24901,1,5651549,01/06/2022,26.2,13866,7187,6679,4383,2099,2284
210,1,6307000,3,28542,1,4071008,01/06/2022,26.6,23363,12127,11236,7776,3818,3958
211,1,14191000,3,25712,1,9198438,01/06/2022,24.7,18224,9500,8724,7072,3514,3558
212,1,12170000,3,29966,1,7880534,01/06/2022,28.3,16447,8464,7983,4843,2381,2462
213,1,4823000,3,14021,1,3120929,01/06/2022,24.2,17550,9283,8267,5700,2861,2839
214,2,60961000,1,152389,2,39472261,01/06/2022,17.7,297848,156299,141549,74787,37046,37741
215,1,25543000,3,32468,1,16570482,01/06/2022,20.8,29390,15521,13869,7939,3942,3997
216,2,30805000,2,66600,2,19956650,01/06/2022,20.4,37608,20094,17514,11115,5490,5625
217,2,35674000,2,66138,2,23121962,01/06/2022,18.3,106163,56161,50002,30752,15034,15718
218,1,12928000,3,21970,1,8381230,01/06/2022,16.1,11149,5894,5255,2996,1479,1517
219,2,34957000,2,52498,2,22669552,01/06/2022,15.6,60265,30945,29320,18808,9224,9584
220,1,17920000,3,32919,1,11615081,01/06/2022,20.5,17718,9411,8307,4913,2492,2421
221,1,17418000,3,31987,1,11289713,01/06/2022,19,36618,19077,17541,10530,5273,5257
222,1,10828000,3,24098,1,7014102,01/06/2022,22.3,9853,5224,4629,2757,1390,1367
223,1,2692000,3,24460,1,1725340,01/06/2022,18.9,27713,14561,13152,7736,3885,3851
224,1,6786000,3,20826,1,4390074,01/06/2022,19.3,32276,17014,15262,9457,4578,4879
225,1,7851000,3,21370,1,5081780,01/06/2022,20.9,14689,7582,7107,4123,2033,2090
226,2,35873000,3,43583,2,23273867,01/06/2022,25.4,44311,23331,20980,13756,6771,6985
227,1,4207000,3,22024,1,2712526,01/06/2022,22.9,14732,7791,6941,4911,2433,2478
228,1,10827000,3,23725,1,7013825,01/06/2022,18,20530,10890,9640,6356,3180,3176
229,1,11381000,3,21292,1,7376358,01/06/2022,27.6,16368,8558,7810,4728,2323,2405
230,1,7613000,3,23256,1,4925194,01/06/2022,14.7,6213,3216,2997,1786,871,915
231,1,10006000,3,23891,1,6480009,01/06/2022,15.6,28792,15288,13504,8327,4111,4216
233,1,4680000,3,6731,1,3035269,01/06/2022,20.4,8657,4501,4156,2464,1200,1264
234,2,66149000,2,103079,2,42893771,01/06/2022,27.2,224166,112147,112019,65088,31954,33134
235,1,27282000,2,73766,1,17659534,01/06/2022,22.2,111569,57370,54199,36412,17892,18520
236,1,25975000,3,32282,1,16851468,01/06/2022,23.5,38780,20122,18658,13025,6461,6564
237,3,146996000,1,337119,3,95210281,01/06/2022,22,1385621,718628,666993,333198,164217,168981
238,2,98392000,1,248599,2,63706201,01/06/2022,22.9,1257547,645398,612149,321993,158559,163434
239,1,20364000,3,27690,1,13208910,01/06/2022,24.7,37871,19554,18317,11359,5732,5627
240,2,81308000,1,206328,2,52643872,01/06/2022,25.3,650123,329365,320758,200033,98558,101475
241,2,38641000,2,65061,2,25051589,01/06/2022,22.9,111975,57735,54240,31481,15460,16021
242,1,13792000,3,24406,1,8940394,01/06/2022,23.5,98842,50427,48415,30938,15263,15675
243,2,62743000,1,195602,2,40587348,01/06/2022,23.3,44103,22420,21683,15768,7755,8013
244,1,10822000,3,26490,1,7007810,01/06/2022,23.2,53539,27205,26334,18000,8916,9084
245,1,9628000,3,25393,1,6232807,01/06/2022,28.1,18787,9476,9311,6502,3270,3232
246,1,15498000,3,38788,1,10034912,01/06/2022,23.5,59648,30609,29039,19344,9536,9808
247,2,52845000,2,95648,2,34253602,01/06/2022,22.9,30471,15635,14836,9610,4654,4956
248,1,4179000,3,21494,1,2694856,01/06/2022,23.2,20286,10307,9979,6804,3413,3391
249,1,4014000,3,20208,1,2588892,01/06/2022,23.5,20345,10131,10214,6733,3300,3433
250,1,19457000,3,37352,1,12609698,01/06/2022,23.8,31115,15891,15224,10525,5240,5285
251,1,12947000,3,43397,1,8372153,01/06/2022,23.2,16550,8456,8094,5252,2552,2700
252,1,15617000,3,24009,1,10127041,01/06/2022,23.4,24352,12627,11725,8092,4062,4030
253,1,18629000,3,42804,1,12066046,01/06/2022,21.4,94978,48709,46269,29794,14672,15122
254,1,19740000,3,26861,1,12804139,01/06/2022,26.8,52019,26739,25280,15725,7759,7966
255,1,3438000,3,24876,1,2209824,01/06/2022,24.5,24580,12765,11815,8215,4057,4158
256,1,13326000,3,24547,1,8637353,01/06/2022,24.6,28678,14679,13999,9074,4497,4577
257,1,3846000,3,20826,1,2479074,01/06/2022,18.6,22738,11719,11019,7000,3537,3463
258,1,10797000,3,21149,1,6996901,01/06/2022,22.9,28145,14670,13475,8863,4390,4473
259,1,8884000,3,20380,1,5754220,01/06/2022,22.9,19113,9852,9261,5504,2716,2788
260,1,2040000,3,20596,1,1305404,01/06/2022,23.2,25925,13382,12543,8585,4189,4396
261,1,953000,3,27150,1,592300,01/06/2022,24.6,13033,6697,6336,4420,2181,2239
262,1,2394000,3,20759,1,1535341,01/06/2022,10.9,5955,3118,2837,1972,974,998
263,1,1651000,3,21344,1,1051806,01/06/2022,23.8,8850,4524,4326,2773,1377,1396
264,1,2458000,3,19010,1,1578690,01/06/2022,18.6,9529,4943,4586,3018,1490,1528
265,1,9650000,3,33766,1,6238734,01/06/2022,23.2,14636,7533,7103,4910,2424,2486
266,1,17262000,3,35219,1,11185081,01/06/2022,23.2,40906,20800,20106,12864,6409,6455
267,1,5957000,3,24265,1,3847785,01/06/2022,22.9,8142,4289,3853,2686,1333,1353
268,1,1916000,3,26762,1,1218638,01/06/2022,18.3,7954,4060,3894,2570,1274,1296
269,1,10480000,3,23274,1,6788726,01/06/2022,23.8,17000,8527,8473,5215,2549,2666
270,1,3293000,3,26806,1,2113644,01/06/2022,21.9,14424,7439,6985,5399,2678,2721
271,1,2657000,3,20720,1,1706330,01/06/2022,23.8,16873,8725,8148,6022,3008,3014
272,1,2784000,3,17449,1,1792151,01/06/2022,22.9,5109,2618,2491,1631,805,826
273,1,2225000,3,21041,1,1425209,01/06/2022,22.9,13243,6795,6448,4043,1954,2089
274,1,2389000,3,20827,1,1532023,01/06/2022,23.2,14497,7627,6870,4260,2099,2161
275,1,2301000,3,18820,1,1476830,01/06/2022,23.2,16324,8373,7951,5562,2774,2788
276,1,5235000,3,21465,1,3381285,01/06/2022,27.7,9842,5047,4795,3323,1629,1694
277,1,2745000,3,20049,1,1764201,01/06/2022,23.2,27833,14525,13308,9097,4581,4516
278,1,4515000,3,6228,1,2928522,01/06/2022,23.4,33284,17172,16112,10804,5349,5455
279,1,2126000,3,21047,1,1360853,01/06/2022,24.9,14697,7601,7096,4740,2380,2360
280,1,4494000,3,20435,1,2900665,01/06/2022,21.4,18607,9363,9244,6403,3178,3225
284,2,97723000,1,159910,2,63360040,01/06/2022,21.1,743275,388114,355161,202467,99875,102592
285,2,38305000,2,88437,2,24809813,01/06/2022,18.7,154546,80401,74145,48513,24003,24510
286,2,67194000,1,108092,2,43568008,01/06/2022,20.3,299523,155411,144112,93845,46362,47483
287,2,45562000,2,79763,2,29535537,01/06/2022,28.7,83637,42325,41312,24783,12286,12497
288,2,34379000,2,75253,2,22271097,01/06/2022,29.6,102362,52461,49901,35162,17416,17746
289,1,16849000,3,31298,1,10920552,01/06/2022,22.9,55287,28877,26410,16959,8447,8512
290,1,21702000,3,36521,1,14069779,01/06/2022,24,87042,45232,41810,26414,12958,13456
291,2,34689000,2,59086,2,22488764,01/06/2022,12.6,86901,45620,41281,26262,13160,13102
292,1,20551000,3,22575,1,13335575,01/06/2022,21.3,30519,15931,14588,10809,5325,5484
293,2,29745000,3,37303,2,19296947,01/06/2022,20.3,60811,31893,28918,19713,9706,10007
294,1,3241000,3,12111,1,2094539,01/06/2022,18.6,61510,31765,29745,21000,10487,10513
295,1,21335000,3,50596,1,13817154,01/06/2022,18.9,70042,36241,33801,21818,10809,11009
296,1,3986000,3,12240,1,2578660,01/06/2022,20.6,24662,12965,11697,6937,3350,3587
297,1,5151000,3,19513,1,3328637,01/06/2022,18.6,15414,7999,7415,4635,2291,2344
298,1,21360000,3,21718,1,13862282,01/06/2022,19.2,71528,37497,34031,23278,11539,11739
299,1,2267000,3,21364,1,1452186,01/06/2022,21.3,15249,7932,7317,4894,2453,2441
300,1,24466000,3,22446,1,15880454,01/06/2022,19.9,39425,20578,18847,13203,6477,6726
301,1,3700000,3,21250,1,2383750,01/06/2022,20.6,17293,8766,8527,5650,2795,2855
302,1,11051000,3,22404,1,7160746,01/06/2022,12.6,16905,8772,8133,5514,2740,2774
303,1,3676000,3,27036,1,2362364,01/06/2022,20.3,18097,9360,8737,5881,2892,2989
304,1,12681000,3,22446,1,8220204,01/06/2022,22.5,32333,16690,15643,10314,5057,5257
305,1,18006000,3,28190,1,11675710,01/06/2022,21.5,49940,25545,24395,16071,7998,8073
306,1,15675000,3,25141,1,10163609,01/06/2022,20.5,1049,546,503,282,149,133
307,1,13335000,3,28074,1,8639676,01/06/2022,20.7,6853,3584,3269,2311,1149,1162
308,1,6614000,3,6025,1,4293075,01/06/2022,28.2,12262,6119,6143,4251,2104,2147
309,1,2689000,3,30198,1,1717652,01/06/2022,21.5,11086,5609,5477,3615,1780,1835
310,1,3029000,3,27565,1,1941285,01/06/2022,24,13821,7083,6738,3938,1966,1972
311,2,47871000,1,154374,2,30961776,01/06/2022,23.4,341029,180370,160659,82444,40670,41774
312,2,66859000,2,101675,2,43356675,01/06/2022,24.2,157336,82380,74956,43883,21497,22386
313,1,21570000,3,19400,1,14001100,01/06/2022,27.6,174629,91268,83361,46521,22880,23641
314,1,28352000,3,50020,1,18378780,01/06/2022,26,104461,54150,50311,30967,15315,15652
315,1,15532000,2,52382,1,10043418,01/06/2022,25.1,44353,23038,21315,13070,6400,6670
316,1,5013000,3,24534,1,3233916,01/06/2022,27.5,21375,11206,10169,5662,2753,2909
317,2,29342000,3,41951,2,19030349,01/06/2022,27.6,17777,9225,8552,4254,2086,2168
318,2,36547000,2,93296,2,23662254,01/06/2022,27.6,64084,32934,31150,19785,9668,10117
319,1,13898000,3,28288,1,9005412,01/06/2022,27.6,20434,10867,9567,5939,2970,2969
320,1,13443000,3,32636,1,8705314,01/06/2022,18.1,19085,9763,9322,6343,3119,3224
321,2,89428000,1,109867,2,58018333,01/06/2022,24.4,371387,192530,178857,106784,52432,54352
322,1,17928000,3,21195,1,11632005,01/06/2022,27.2,18023,9240,8783,5154,2503,2651
323,1,12246000,3,40373,1,7919527,01/06/2022,25.6,20322,10479,9843,6201,3025,3176
324,1,17545000,3,28836,1,11375414,01/06/2022,25.6,25477,13300,12177,8208,4059,4149
325,1,7875000,2,52185,1,5066565,01/06/2022,29.4,13620,7015,6605,4098,1994,2104
326,1,11094000,3,22558,1,7188542,01/06/2022,25.6,48170,25016,23154,15515,7657,7858
327,1,8243000,3,45345,1,5312605,01/06/2022,30.5,10593,5340,5253,3485,1705,1780
328,2,34781000,2,65920,2,22541730,01/06/2022,27.2,8730,4395,4335,2894,1447,1447
329,1,3784000,3,27380,1,2432220,01/06/2022,29.1,14678,7367,7311,4863,2405,2458
330,1,7369000,3,30232,1,4759618,01/06/2022,27.2,10935,5450,5485,3532,1706,1826
331,1,8667000,3,25055,1,5608495,01/06/2022,30.4,19976,10345,9631,6431,3120,3311
332,2,59301000,1,105891,2,38439759,01/06/2022,30.7,412199,209241,202958,82879,40585,42294
333,2,58000000,1,114314,2,37585686,01/06/2022,30.8,304052,152635,151417,84118,41457,42661
334,2,85830000,1,128836,2,55660664,01/06/2022,28.6,536436,267279,269157,158598,77797,80801
335,3,117669000,1,145144,3,76339706,01/06/2022,28.6,635862,320627,315235,153834,75737,78097
336,3,141110000,1,201394,3,91520106,01/06/2022,29.4,1142952,578172,564780,270109,132170,137939
338,1,15692000,3,29671,1,10170129,01/06/2022,28.6,75721,38037,37684,21903,10795,11108
339,1,19411000,3,33869,1,12583281,01/06/2022,32.1,70378,35870,34508,21367,10464,10903
340,2,42011000,3,25118,2,27282032,01/06/2022,18.6,308285,152976,155309,108145,53196,54949
342,2,40888000,2,60091,2,26517109,01/06/2022,27,234698,115478,119220,87040,43098,43942
343,1,12305000,3,25374,1,7972876,01/06/2022,28.6,28843,14318,14525,8529,4190,4339
344,1,11937000,3,22855,1,7736195,01/06/2022,29.5,33522,17126,16396,9330,4711,4619
345,1,16012000,3,44041,1,10363759,01/06/2022,29.9,54467,27606,26861,15858,7789,8069
346,1,16654000,3,19422,1,10805678,01/06/2022,30.7,13059,6525,6534,4137,2073,2064
347,1,1285000,3,2984,1,832266,01/06/2022,18.6,9934,4952,4982,3082,1558,1524
348,1,4683000,3,23341,1,3020609,01/06/2022,18.6,7844,4131,3713,2621,1355,1266
349,1,8746000,3,50580,1,5634320,01/06/2022,28.6,48069,23121,24948,16392,8040,8352
350,1,11123000,3,26138,1,7203812,01/06/2022,30.8,11583,5810,5773,3713,1872,1841
351,1,3971000,3,19613,1,2561537,01/06/2022,27.3,29903,15539,14364,9778,4798,4980
352,3,123744000,1,215549,3,80218051,01/06/2022,23.8,258913,138803,120110,68042,33683,34359
353,2,45290000,2,79345,2,29359155,01/06/2022,28.1,103609,54904,48705,31555,15575,15980
354,1,25469000,2,66963,1,16487887,01/06/2022,28.7,76660,40113,36547,21596,10646,10950
355,2,32218000,3,43823,2,20897877,01/06/2022,29,88280,46038,42242,25864,12608,13256
356,1,26739000,3,50314,1,17330036,01/06/2022,23.1,56163,29689,26474,18214,8872,9342
357,1,2064000,3,27020,1,1314580,01/06/2022,28.1,7263,3837,3426,2540,1279,1261
358,1,13919000,3,22540,1,9024810,01/06/2022,28.1,16645,8759,7886,5075,2484,2591
359,1,12259000,3,47164,1,7921186,01/06/2022,26.6,31469,16729,14740,9837,4899,4938
360,1,12128000,3,25022,1,7858178,01/06/2022,17.2,12729,6935,5794,4541,2296,2245
361,1,10417000,3,23665,1,6747385,01/06/2022,29,26015,13735,12280,7360,3633,3727
362,2,37359000,3,27050,2,24256300,01/06/2022,27.3,29903,15539,14364,9778,4798,4980
363,1,22852000,3,34187,1,14819613,01/06/2022,27.1,10504,5405,5099,3440,1722,1718
364,1,15304000,3,29111,1,9918489,01/06/2022,28.7,45134,23442,21692,13494,6690,6804
365,1,19200000,3,30249,1,12449751,01/06/2022,20.8,29130,15431,13699,9957,5019,4938
366,1,4510000,3,18381,1,2913119,01/06/2022,26.7,5812,3105,2707,1767,906,861
367,1,11827000,3,27349,1,7660201,01/06/2022,17.2,15851,8463,7388,5625,2839,2786
368,1,5269000,3,20725,1,3404125,01/06/2022,20.8,15298,8185,7113,4499,2268,2231
369,1,23795000,3,25430,1,15441320,01/06/2022,29,17525,9370,8155,5075,2488,2587
370,1,16823000,2,68695,1,10866255,01/06/2022,17.2,18915,10248,8667,6395,3217,3178
371,1,20218000,3,20374,1,13121326,01/06/2022,22.3,81848,43535,38313,23849,11894,11955
372,2,34131000,3,39735,2,22145415,01/06/2022,22.1,33726,17513,16213,11096,5372,5724
373,1,2246000,3,36241,1,1423659,01/06/2022,20.8,11168,5931,5237,3889,1954,1935
374,1,5098000,3,23256,1,3290444,01/06/2022,28.1,6341,3343,2998,2049,979,1070
375,1,19437000,3,17159,1,12616891,01/06/2022,22.3,45895,23816,22079,12162,5997,6165
376,1,5173000,3,37875,1,3324575,01/06/2022,26.1,6863,3664,3199,2612,1321,1291
377,1,9283000,3,27435,1,6006515,01/06/2022,22.1,10611,5602,5009,3876,1871,2005
378,1,3404000,3,21021,1,2191579,01/06/2022,28.1,14226,7514,6712,4380,2214,2166
379,1,4827000,3,22244,1,3115306,01/06/2022,22.3,7997,4114,3883,2359,1161,1198
380,1,3636000,3,11093,1,2352307,01/06/2022,26.6,4188,2243,1945,1509,761,748
381,1,25986000,3,50882,1,16840018,01/06/2022,27.3,15373,8115,7258,5203,2638,2565
382,1,14421000,3,20863,1,9352787,01/06/2022,28.2,14071,7408,6663,4497,2251,2246
383,1,1792000,3,19132,1,1145668,01/06/2022,17.2,6642,3720,2922,2058,1005,1053
384,1,5701000,3,5057,1,3700593,01/06/2022,27.3,11054,5638,5416,3563,1745,1818
385,3,197795000,1,404278,3,128162472,01/06/2022,19.9,1542232,806262,735970,402209,198130,204079
386,2,41713000,2,59750,2,27053700,01/06/2022,17.9,78264,40929,37335,23163,11368,11795
387,2,56844000,2,97680,2,36850920,01/06/2022,20.6,293825,155300,138525,93203,46206,46997
388,1,25324000,2,58489,1,16402111,01/06/2022,28,49578,26095,23483,16381,8171,8210
389,2,32938000,3,47286,2,21362414,01/06/2022,20.5,89314,47398,41916,25892,12760,13132
390,2,38068000,3,36358,2,24707842,01/06/2022,19.9,31315,16320,14995,10348,5100,5248
391,1,17061000,3,44749,1,11044901,01/06/2022,15.3,39203,20881,18322,12964,6446,6518
392,1,18891000,3,46592,1,12232558,01/06/2022,19.7,58957,31503,27454,19229,9506,9723
393,2,31465000,2,87315,2,20364935,01/06/2022,17,62849,33939,28910,17954,8876,9078
394,1,16848000,3,34135,1,10917065,01/06/2022,16.2,25468,13582,11886,8293,4136,4157
395,1,20150000,3,41371,1,13056129,01/06/2022,15.3,31599,16595,15004,11708,5967,5741
396,1,25967000,3,49751,1,16828799,01/06/2022,15.3,29123,15247,13876,9589,4733,4856
397,1,14893000,3,24378,1,9656072,01/06/2022,19.6,18110,9443,8667,6325,3046,3279
398,1,10360000,3,45492,1,6688508,01/06/2022,15.3,31695,16422,15273,11280,5582,5698
399,1,14854000,3,30909,1,9624191,01/06/2022,15.3,95322,48884,46438,32521,16133,16388
400,1,12695000,3,24696,1,8227054,01/06/2022,15.3,9358,5013,4345,2738,1323,1415
401,1,10280000,2,54292,1,6627708,01/06/2022,18.6,9149,4948,4201,2691,1357,1334
402,1,2979000,3,20596,1,1915754,01/06/2022,15.3,9913,5282,4631,3496,1711,1785
403,1,9739000,3,11384,1,6318966,01/06/2022,15.3,36620,18819,17801,10303,4961,5342
404,1,1777000,3,21043,1,1134007,01/06/2022,15.3,5276,2719,2557,1830,893,937
405,1,16241000,3,22404,1,10534246,01/06/2022,15.3,41455,21994,19461,13993,6843,7150
406,1,15322000,3,20904,1,9938396,01/06/2022,18.4,29613,15403,14210,9414,4672,4742
408,1,9935000,3,21635,1,6436115,01/06/2022,17.2,13922,7166,6756,5211,2590,2621
409,1,3199000,3,19008,1,2060342,01/06/2022,15.3,10960,5789,5171,3556,1785,1771
410,1,10786000,3,22471,1,6988429,01/06/2022,12.6,22904,12086,10818,7644,3743,3901
411,1,7230000,3,23334,1,4676166,01/06/2022,15.3,11776,6077,5699,3730,1832,1898
412,1,1548000,3,7306,1,998894,01/06/2022,15.3,16797,8560,8237,5425,2652,2773
413,1,2873000,3,27150,1,1840300,01/06/2022,15.3,19648,10052,9596,6751,3334,3417
414,1,13344000,3,23343,1,8650257,01/06/2022,25.9,19341,10302,9039,6428,3158,3270
415,1,2821000,3,22241,1,1811409,01/06/2022,15.5,11487,6208,5279,3749,1855,1894
416,1,4493000,3,15652,1,2904798,01/06/2022,15.3,5703,2985,2718,1959,971,988
417,1,1628000,3,18536,1,1039664,01/06/2022,15.3,6644,3435,3209,2305,1130,1175
418,1,3126000,3,22867,1,2009033,01/06/2022,15.3,7491,3982,3509,2583,1266,1317
419,1,1679000,3,12598,1,1078752,01/06/2022,15.3,8481,4360,4121,2849,1391,1458
420,1,20268000,3,33805,1,13140395,01/06/2022,19.5,46996,24240,22756,12187,6012,6175
421,1,2262000,3,19134,1,1451166,01/06/2022,21.5,8445,4468,3977,3005,1505,1500
422,1,4892000,3,21883,1,3157917,01/06/2022,17.6,5612,3027,2585,1851,938,913
423,1,6290000,3,24977,1,4063523,01/06/2022,27.4,5276,2719,2557,1830,893,937
424,3,163145000,1,243642,3,105800608,01/06/2022,21.5,794789,407239,387550,199480,98049,101431
425,2,42485000,2,69837,2,27545413,01/06/2022,18.3,177719,91525,86194,50219,24680,25539
426,1,17012000,3,23533,1,11034267,01/06/2022,18.3,34955,18206,16749,9854,4805,5049
427,1,2171000,3,20252,1,1390898,01/06/2022,18.4,115264,60166,55098,28758,14392,14366
428,1,13295000,3,27849,1,8613901,01/06/2022,18.3,16795,8697,8098,5436,2628,2808
429,1,5618000,3,20482,1,3631218,01/06/2022,21.9,13390,6831,6559,4033,1966,2067
430,1,7088000,3,28094,1,4579106,01/06/2022,21.9,7953,4224,3729,2375,1195,1180
431,1,6821000,3,19231,1,4414419,01/06/2022,27,15512,8121,7391,5093,2493,2600
432,2,50471000,3,49047,2,32757103,01/06/2022,29.1,169028,86790,82238,45879,22689,23190
433,3,145672000,1,164934,3,94521866,01/06/2022,29.6,888797,441181,447616,247410,121384,126026
434,2,63092000,2,70716,2,40939084,01/06/2022,27.2,304942,149380,155562,85665,42398,43267
435,1,24136000,2,59446,1,15628954,01/06/2022,29,84519,42292,42227,24955,12440,12515
436,1,15034000,3,29115,1,9742985,01/06/2022,28.3,30754,15948,14806,10320,5221,5099
437,3,125011000,1,136278,3,81120872,01/06/2022,21.2,845941,437370,408571,227808,112567,115241
438,2,51271000,2,58074,2,33268076,01/06/2022,30.4,136351,71718,64633,38918,19062,19856
439,1,26535000,2,77165,1,17170585,01/06/2022,26.1,86686,44901,41785,27406,13467,13939
440,1,26025000,3,45253,1,16870997,01/06/2022,26.1,58158,30570,27588,17715,8934,8781
441,1,21644000,2,63844,1,14004756,01/06/2022,29.5,24258,12834,11424,7258,3602,3656
442,1,11206000,3,30526,1,7253374,01/06/2022,29.4,24454,12691,11763,7326,3576,3750
443,1,20947000,3,25992,1,13589558,01/06/2022,20.6,310192,159130,151062,94872,46787,48085
444,1,2774000,3,32001,1,1771099,01/06/2022,22,14340,7646,6694,4731,2430,2301
445,2,54066000,2,67520,2,35075380,01/06/2022,29.4,15341,8078,7263,4842,2416,2426
446,1,4285000,3,26981,1,2758269,01/06/2022,29.5,8045,4283,3762,2501,1247,1254
447,1,8675000,3,23385,1,5615365,01/06/2022,29.5,6644,3540,3104,2086,1058,1028
448,1,3857000,3,20393,1,2486657,01/06/2022,29.4,16582,8647,7935,5030,2477,2553
449,1,23696000,2,79661,1,15322739,01/06/2022,29.8,30796,15740,15056,9239,4503,4736
450,2,57209000,2,84178,2,37101672,01/06/2022,29.6,77849,40866,36983,21990,10871,11119
451,2,31665000,3,46740,2,20535510,01/06/2022,30.3,65215,33971,31244,19700,9733,9967
452,3,108715000,1,149913,3,70514837,01/06/2022,27.8,441975,227109,214866,122010,60145,61865
453,3,248540000,1,262805,3,161288195,01/06/2022,30.7,808416,416251,392165,234633,115277,119356
454,2,80615000,1,129401,2,52270349,01/06/2022,31,298009,154344,143665,83869,41238,42631
455,1,14768000,3,20606,1,9578594,01/06/2022,30.6,33924,17240,16684,10629,5267,5362
456,1,11359000,3,31630,1,7351720,01/06/2022,30.3,14772,7516,7256,4444,2199,2245
457,1,16382000,3,29883,1,10618417,01/06/2022,29,19742,9908,9834,6831,3367,3464
458,1,9808000,3,28844,1,6346356,01/06/2022,33.7,12848,6693,6155,3711,1831,1880
459,1,10377000,3,27610,1,6717440,01/06/2022,30,5457,2839,2618,1473,755,718
460,1,5836000,3,28052,1,3765348,01/06/2022,30.2,5926,3043,2883,1700,842,858
461,1,10663000,3,29482,1,6901468,01/06/2022,30.6,17097,8801,8296,5359,2662,2697
462,1,12473000,3,45518,1,8061932,01/06/2022,29.8,28239,14113,14126,8795,4312,4483
463,1,9894000,3,21884,1,6409216,01/06/2022,28.3,16934,8502,8432,5395,2626,2769
464,1,11877000,3,46429,1,7673621,01/06/2022,29.4,11851,5973,5878,3739,1841,1898
465,1,5953000,3,23199,1,3846251,01/06/2022,31.6,25157,12582,12575,8765,4230,4535
466,1,3250000,3,26136,1,2086364,01/06/2022,31.3,6055,3107,2948,1652,803,849
467,1,2393000,3,20941,1,1534509,01/06/2022,31.6,22421,11364,11057,6263,3134,3129
468,1,2028000,3,20826,1,1297374,01/06/2022,28.3,9864,5093,4771,3123,1529,1594
469,1,3178000,3,20385,1,2045315,01/06/2022,29,7888,4037,3851,3058,1509,1549
470,1,4163000,3,21661,1,2684289,01/06/2022,30,5524,2885,2639,1817,894,923
472,1,2775000,3,18331,1,1785419,01/06/2022,34.2,10328,5288,5040,3690,1794,1896
473,1,803000,3,21305,1,500645,01/06/2022,29,4810,2229,2581,1556,759,797
474,2,78254000,1,141400,2,50723700,01/06/2022,32,329404,168547,160857,90108,44605,45503
475,3,145429000,1,255836,3,94273014,01/06/2022,32,855563,431621,423942,240318,117646,122672
476,2,30411000,2,76961,2,19690189,01/06/2022,30,117253,59414,57839,33098,16300,16798
477,2,59570000,2,57783,2,38662717,01/06/2022,33.3,176685,87738,88947,53884,26504,27380
478,2,64763000,1,115743,2,41980207,01/06/2022,27.6,261137,131158,129979,84004,41439,42565
479,2,35020000,3,49214,2,22713786,01/06/2022,31.6,120926,61958,58968,34805,17098,17707
480,1,24553000,3,32644,1,15926806,01/06/2022,31.7,67604,34141,33463,21101,10330,10771
481,1,11692000,3,23265,1,7576535,01/06/2022,29.4,38886,19733,19153,11641,5731,5910
482,1,13972000,3,26168,1,9055632,01/06/2022,29.6,30324,15540,14784,8298,4088,4210
483,1,27765000,3,33561,1,18013689,01/06/2022,27.5,91029,45722,45307,30379,15003,15376
484,1,23363000,3,29560,1,15156390,01/06/2022,31.1,62301,30877,31424,20494,10127,10367
485,1,2515000,3,20596,1,1614154,01/06/2022,28.1,12987,6460,6527,4296,2156,2140
486,1,17183000,3,28498,1,11140452,01/06/2022,26.1,38113,19225,18888,12385,6138,6247
487,1,1961000,3,23885,1,1250765,01/06/2022,33.2,12372,6340,6032,3845,1851,1994
488,1,11975000,3,26691,1,7757059,01/06/2022,31.3,39474,19169,20305,14904,7336,7568
489,1,12033000,3,22485,1,7798965,01/06/2022,23.4,30429,15578,14851,9786,4826,4960
490,1,4935000,3,24325,1,3183425,01/06/2022,29.6,13153,6653,6500,4059,2009,2050
491,1,4381000,3,22624,1,2825026,01/06/2022,30.6,11440,5836,5604,4121,2095,2026
492,1,2165000,3,26767,1,1380483,01/06/2022,29.9,4787,2437,2350,1357,684,673
493,2,92346000,1,156276,2,59868624,01/06/2022,26.9,340060,178122,161938,86078,42456,43622
494,2,42713000,3,40148,2,27723302,01/06/2022,28.1,43035,22773,20262,11996,6054,5942
495,1,19367000,3,32249,1,12556301,01/06/2022,28.6,27182,14325,12857,8434,4220,4214
496,1,13567000,3,21797,1,8796753,01/06/2022,28.1,21003,10909,10094,6452,3209,3243
497,1,20528000,3,36213,1,13306987,01/06/2022,28.6,31435,16316,15119,9125,4445,4680
498,1,15321000,3,39852,1,9918798,01/06/2022,27.9,29068,15153,13915,8638,4280,4358
499,1,17787000,3,22961,1,11538589,01/06/2022,28.5,25555,13197,12358,7191,3479,3712
500,1,6085000,3,21803,1,3933447,01/06/2022,27.8,13944,7272,6672,4420,2177,2243
501,1,17659000,3,26152,1,11452198,01/06/2022,27.8,34946,17956,16990,11208,5422,5786
502,1,11166000,3,32212,1,7225688,01/06/2022,29.5,16679,8618,8061,4633,2284,2349
503,2,60129000,2,76506,2,39007344,01/06/2022,28.9,297373,155718,141655,71865,35366,36499
504,3,162336000,1,187475,3,105330925,01/06/2022,28.4,691557,348387,343170,213267,104895,108372
505,2,80854000,2,65332,2,52489768,01/06/2022,31.9,416055,211059,204996,132268,65355,66913
506,1,20901000,3,30148,1,13555502,01/06/2022,29.9,111314,55902,55412,35576,17423,18153
507,2,62776000,2,85883,2,40718517,01/06/2022,29.6,332100,171749,160351,94911,46503,48408
508,2,30744000,3,48653,2,19934947,01/06/2022,30.9,79515,41903,37612,21445,10720,10725
509,2,30384000,2,67301,2,19682299,01/06/2022,28.2,205933,107685,98248,49242,24249,24993
510,1,12713000,3,21636,1,8241814,01/06/2022,31,48172,24667,23505,15031,7399,7632
511,1,9262000,3,23665,1,5996635,01/06/2022,29.9,18592,8945,9647,4116,2046,2070
512,2,29067000,3,37755,2,18855795,01/06/2022,29.1,79824,40689,39135,24808,12213,12595
513,1,2083000,3,18896,1,1335054,01/06/2022,29.9,10327,5388,4939,2996,1506,1490
514,1,7281000,3,20367,1,4712283,01/06/2022,29.9,28215,14347,13868,9384,4582,4802
515,1,5509000,3,6355,1,3574495,01/06/2022,29.4,10993,5737,5256,3544,1803,1741
517,1,23697000,3,41676,1,15361374,01/06/2022,15.5,53373,27810,25563,15744,7755,7989
518,2,31161000,2,72876,2,20181774,01/06/2022,19,13555,7357,6198,3051,1547,1504
519,1,24318000,3,38822,1,15767878,01/06/2022,15.6,59871,31271,28600,19112,9469,9643
520,2,40963000,2,68636,2,26557314,01/06/2022,18.1,47632,25410,22222,12563,6265,6298
521,1,18512000,3,30189,1,12002611,01/06/2022,19,45587,23716,21871,14000,6913,7087
522,1,11147000,3,29000,1,7216550,01/06/2022,14.2,37704,19683,18021,12453,6131,6322
523,1,12610000,3,19683,1,8176817,01/06/2022,15.5,70224,35655,34569,24421,12033,12388
524,1,2944000,3,19864,1,1893736,01/06/2022,15.5,17978,9382,8596,6248,3105,3143
525,1,1553000,3,22773,1,986677,01/06/2022,15.5,13401,6929,6472,4288,2149,2139
526,1,1272000,3,14630,1,812170,01/06/2022,15.5,30417,15670,14747,9405,4719,4686
527,1,7237000,3,29856,1,4674194,01/06/2022,15.5,28657,14853,13804,9078,4552,4526
528,1,1157000,3,11206,1,740844,01/06/2022,15.5,1583,826,757,480,230,250
529,2,53082000,2,79313,2,34423987,01/06/2022,23.6,139075,74465,64610,36819,18286,18533
530,2,57006000,2,82319,2,36971581,01/06/2022,21.4,120500,65043,55457,29046,14403,14643
531,2,60852000,3,49582,2,39504218,01/06/2022,27.6,101336,54039,47297,24763,12096,12667
532,3,130933000,1,301414,3,84805036,01/06/2022,27.6,405952,215818,190134,89205,43880,45325
533,2,54709000,2,99302,2,35461548,01/06/2022,26.7,212540,111746,100794,51580,25268,26312
534,2,55801000,1,132852,2,36137798,01/06/2022,29.1,180057,96347,83710,45301,22589,22712
535,2,66491000,1,206001,2,43013149,01/06/2022,20.9,443063,237967,205096,110147,54509,55638
536,1,22714000,3,26375,1,14737725,01/06/2022,28.4,33226,17650,15576,10241,5095,5146
537,1,7883000,3,24694,1,5099256,01/06/2022,27.1,15512,8193,7319,4859,2440,2419
538,2,37424000,2,57276,2,24268324,01/06/2022,25.6,64445,34215,30230,17692,8626,9066
539,2,33524000,3,51994,2,21738606,01/06/2022,28,48567,25769,22798,13570,6693,6877
540,1,20847000,3,23652,1,13526898,01/06/2022,14.8,42451,22342,20109,14824,7241,7583
541,1,16073000,3,27540,1,10419910,01/06/2022,29.8,41588,21739,19849,12522,6161,6361
543,1,21766000,3,47091,1,14100809,01/06/2022,29.1,55452,29697,25755,14940,7380,7560
544,1,1805000,3,20687,1,1152563,01/06/2022,27.6,6076,3180,2896,1703,844,859
545,2,37341000,2,59840,2,24211810,01/06/2022,29.1,64692,34002,30690,19678,9778,9900
546,1,4146000,3,24212,1,2670688,01/06/2022,27.5,22760,12125,10635,6420,3229,3191
547,1,14304000,3,32508,1,9265092,01/06/2022,28.7,25608,13480,12128,7723,3870,3853
548,1,9967000,2,54680,1,6423870,01/06/2022,25.6,15733,8506,7227,4079,2054,2025
549,1,7730000,3,22912,1,5001588,01/06/2022,21.4,41785,22480,19305,10854,5445,5409
550,1,9643000,3,35858,1,6232092,01/06/2022,26.8,13225,6946,6279,3476,1669,1807
551,1,13415000,3,34456,1,8685294,01/06/2022,20.5,28655,15243,13412,8764,4302,4462
552,1,6227000,3,31889,1,4015661,01/06/2022,26,17727,9423,8304,4199,2068,2131
553,1,11544000,2,88668,1,7414932,01/06/2022,27.1,8969,4883,4086,2821,1444,1377
554,1,10696000,3,22239,1,6930161,01/06/2022,28.2,16758,8967,7791,4993,2542,2451
555,2,32013000,3,43247,2,20765203,01/06/2022,27.2,47035,25085,21950,12872,6289,6583
556,1,17145000,3,27894,1,11116356,01/06/2022,26.9,55720,29557,26163,14521,7123,7398
557,1,17930000,3,26440,1,11628060,01/06/2022,25.7,46909,24866,22043,15156,7483,7673
558,1,12338000,3,28714,1,7990986,01/06/2022,25.7,33986,17827,16159,9043,4421,4622
559,1,12598000,3,26496,1,8162204,01/06/2022,21.4,34847,18666,16181,8943,4380,4563
560,1,13518000,3,33940,1,8752760,01/06/2022,27.7,14304,7545,6759,4455,2182,2273
561,1,7953000,3,24876,1,5144574,01/06/2022,26.9,20797,10995,9802,4991,2418,2573
562,1,14191000,3,22446,1,9201704,01/06/2022,27.5,30232,15727,14505,8913,4281,4632
563,1,25068000,2,62545,1,16231655,01/06/2022,27.4,20165,10621,9544,5395,2701,2694
564,1,2486000,3,23393,1,1592507,01/06/2022,29.1,20380,10692,9688,6259,3127,3132
565,1,10364000,3,26237,1,6710363,01/06/2022,15.8,21640,11976,9664,7433,3885,3548
566,1,18712000,3,32080,1,12130720,01/06/2022,18.4,33402,17876,15526,9753,4761,4992
567,1,20722000,3,41395,1,13427905,01/06/2022,28.3,26236,13620,12616,8067,3962,4105
568,1,3360000,3,20594,1,2163406,01/06/2022,26.1,4405,2358,2047,1451,735,716
569,1,3457000,3,22174,1,2224876,01/06/2022,27.1,13716,7109,6607,3981,1920,2061
570,1,10470000,3,25343,1,6780157,01/06/2022,27.7,5653,2987,2666,1709,826,883
571,1,9554000,3,34019,1,6176081,01/06/2022,28.7,21318,11472,9846,5688,2873,2815
572,1,10346000,3,22068,1,6702832,01/06/2022,27.7,14582,7621,6961,4539,2262,2277
573,1,1691000,3,27321,1,1071829,01/06/2022,27.7,6219,3311,2908,1883,941,942
574,1,9037000,3,29467,1,5844583,01/06/2022,26.4,31856,17018,14838,8563,4318,4245
575,1,14045000,3,22601,1,9106649,01/06/2022,21.4,35893,18883,17010,11399,5600,5799
576,1,15637000,3,29420,1,10134630,01/06/2022,28.7,19272,10328,8944,5163,2534,2629
577,1,14447000,3,27832,1,9362718,01/06/2022,14.5,16364,8711,7653,5250,2654,2596
578,1,9958000,3,25183,1,6447517,01/06/2022,27.6,2820,1449,1371,720,341,379
579,1,1878000,3,19974,1,1200726,01/06/2022,27.9,4654,2510,2144,1296,630,666
580,1,1439000,3,20553,1,914797,01/06/2022,14.5,21585,11243,10342,6456,3197,3259
581,1,1278000,3,21897,1,808803,01/06/2022,27.7,6888,3543,3345,1840,922,918
582,1,1894000,3,21794,1,1209306,01/06/2022,27.6,21391,11404,9987,5619,2742,2877
583,1,1404000,3,20725,1,891875,01/06/2022,27.5,9668,5030,4638,2384,1141,1243
584,1,16368000,3,28190,1,10611010,01/06/2022,26.4,13995,7311,6684,4212,2070,2142
585,1,4422000,3,21198,1,2853102,01/06/2022,26.9,6838,3583,3255,1791,891,900
586,1,1531000,3,20725,1,974425,01/06/2022,27.6,5681,3058,2623,1606,823,783
587,1,7998000,3,25005,1,5173695,01/06/2022,14.5,13966,7679,6287,3739,1859,1880
588,1,11888000,3,18191,1,7709009,01/06/2022,27.4,28076,14773,13303,7550,3752,3798
589,1,5599000,3,25005,1,3614345,01/06/2022,14.4,34039,18008,16031,8858,4334,4524
590,1,1596000,3,18648,1,1018752,01/06/2022,21.4,15807,8231,7576,5949,2955,2994
591,1,1132000,3,12805,1,722995,01/06/2022,26.9,10581,5508,5073,2907,1418,1489
592,1,3296000,3,23600,1,2118800,01/06/2022,19,9554,4935,4619,2707,1302,1405
593,1,12001000,3,51064,1,7749586,01/06/2022,25.7,9988,5342,4646,2237,1127,1110
594,1,2234000,3,12727,1,1439373,01/06/2022,28.9,7578,3984,3594,2088,1031,1057
595,1,2238000,3,22241,1,1432459,01/06/2022,19.6,8005,4106,3899,2599,1296,1303
596,1,3044000,3,20522,1,1958078,01/06/2022,27.4,24085,12288,11797,7909,3780,4129
597,1,3800000,3,21033,1,2448967,01/06/2022,27.6,7455,4054,3401,2223,1145,1078
598,1,950000,3,7223,1,610277,01/06/2022,27.7,17919,9538,8381,4548,2298,2250
599,1,4733000,3,24262,1,3052188,01/06/2022,29.1,15305,8066,7239,4706,2332,2374
600,3,130168000,1,233177,3,84376023,01/06/2022,29.7,921771,479309,442462,222551,109790,112761
601,1,12750000,3,20720,1,8266780,01/06/2022,26.8,26081,13338,12743,7626,3791,3835
602,1,27017000,3,29817,1,17531233,01/06/2022,29.1,56494,29131,27363,17460,8617,8843
603,1,15637000,3,23214,1,10140836,01/06/2022,28.2,52593,26982,25611,16883,8307,8576
604,1,5140000,3,29612,1,3311388,01/06/2022,28,41965,21110,20855,11192,5453,5739
605,1,8034000,3,27448,1,5194652,01/06/2022,28.7,26175,13553,12622,8885,4301,4584
606,1,11482000,3,31559,1,7431741,01/06/2022,27.6,35183,17868,17315,10650,5230,5420
607,1,9939000,3,29810,1,6430540,01/06/2022,27.3,56409,28489,27920,16919,8292,8627
608,1,8029000,3,12954,1,5205896,01/06/2022,27.9,139753,70456,69297,45077,22298,22779
609,1,7067000,3,22050,1,4571500,01/06/2022,28,17841,9042,8799,5372,2677,2695
610,1,7401000,3,22108,1,4788542,01/06/2022,27.9,28461,14574,13887,9148,4533,4615
611,2,39519000,2,59188,2,25628162,01/06/2022,21.8,143281,73905,69376,47529,23519,24010
612,2,40633000,2,98900,2,26312550,01/06/2022,17,138444,72335,66109,38201,18773,19428
613,1,11887000,3,23018,1,7703532,01/06/2022,22.4,22295,11690,10605,8176,4115,4061
614,1,12501000,3,44101,1,8081549,01/06/2022,20.2,25068,12776,12292,8673,4237,4436
615,1,3002000,3,27201,1,1924099,01/06/2022,22.6,15291,7886,7405,5051,2477,2574
616,1,4804000,3,21170,1,3101430,01/06/2022,21.2,38193,19467,18726,13775,6896,6879
617,1,10031000,3,27702,1,6492448,01/06/2022,23.2,46132,23831,22301,13972,6871,7101
618,1,2008000,3,20482,1,1284718,01/06/2022,25.8,13641,7027,6614,4307,2133,2174
1,3,106854000,1,172913,3,69282187,01/05/2022,25.2,863893,444725,419168,260350,128225,132125
2,1,18753000,3,28108,1,12161342,01/05/2022,24.3,31963,16433,15530,11390,5609,5781
3,1,11199000,3,23851,1,7255499,01/05/2022,23.8,63805,32406,31399,23397,11652,11745
4,1,9342000,3,23094,1,6049206,01/05/2022,24.3,21049,10874,10175,7097,3529,3568
5,1,5183000,3,25590,1,3343360,01/05/2022,22.8,32035,16367,15668,10989,5374,5615
6,3,214027000,1,252792,3,138864758,01/05/2022,29.6,854186,425977,428209,227917,112151,115766
7,3,421670000,1,528080,3,273557420,01/05/2022,18.1,1810645,899293,911352,503963,246971,256992
8,2,90012000,2,91103,2,58416697,01/05/2022,17.4,330652,167339,163313,86895,42903,43992
9,2,35555000,3,26528,2,23084222,01/05/2022,18.2,81059,40420,40639,23492,11470,12022
10,2,33427000,3,50950,2,21676600,01/05/2022,17.3,100660,49935,50725,28067,13772,14295
11,1,19745000,3,21979,1,12812271,01/05/2022,26.9,19081,9476,9605,5934,2909,3025
12,2,78277000,1,116027,2,50764023,01/05/2022,27.6,250141,126245,123896,65670,32312,33358
13,2,57137000,2,79782,2,37059268,01/05/2022,23.7,136285,66083,70202,42780,21001,21779
14,2,77495000,2,99645,2,50272105,01/05/2022,23.9,202694,98608,104086,64935,31858,33077
15,1,23374000,3,32164,1,15160936,01/05/2022,22.6,43805,22160,21645,13050,6507,6543
16,1,26510000,2,70373,1,17161127,01/05/2022,26.6,16311,8010,8301,4984,2435,2549
17,1,10464000,3,26039,1,6775561,01/05/2022,24.7,14357,6822,7535,3854,1925,1929
18,1,2796000,3,26013,1,1791387,01/05/2022,16.6,13596,6842,6754,4196,2086,2110
19,1,9252000,3,25117,1,5988683,01/05/2022,20,13596,6842,6754,4196,2086,2110
20,1,3291000,3,25139,1,2114011,01/05/2022,20.1,7185,3509,3676,2099,1015,1084
21,2,43159000,2,65230,2,27988120,01/05/2022,30.1,191238,97313,93925,52600,25862,26738
22,2,42768000,2,63735,2,27735465,01/05/2022,30.7,249623,130524,119099,66498,32635,33863
23,1,28140000,3,26461,1,18264539,01/05/2022,30.3,31375,16375,15000,10682,5317,5365
24,1,18683000,3,28455,1,12115495,01/05/2022,29.9,35799,18291,17508,11962,5883,6079
25,1,11617000,3,28099,1,7522951,01/05/2022,30.1,15949,8217,7732,4538,2234,2304
26,2,83711000,2,81947,2,54330203,01/05/2022,29.4,217550,113613,103937,65123,32048,33075
27,2,47408000,3,44375,2,30770825,01/05/2022,18.5,183509,96930,86579,60413,30246,30167
28,2,49123000,2,68399,2,31861551,01/05/2022,22.3,113479,60064,53415,36594,18199,18395
29,3,103419000,2,96422,3,67125928,01/05/2022,29.1,578830,303756,275074,166456,82025,84431
30,2,39173000,3,32329,2,25430121,01/05/2022,30.8,51797,27093,24704,17614,8812,8802
31,2,62341000,1,119397,2,40402253,01/05/2022,28.4,38087,20017,18070,11916,5833,6083
32,1,12383000,3,22555,1,8026395,01/05/2022,30.4,32109,16780,15329,10495,5074,5421
33,1,25954000,3,21966,1,16848134,01/05/2022,25.5,21727,11415,10312,7786,3890,3896
34,1,16574000,3,28699,1,10744401,01/05/2022,29,49201,25651,23550,16539,8102,8437
35,1,22353000,3,39788,1,14489662,01/05/2022,27,37546,19668,17878,11791,5836,5955
36,1,23192000,2,76820,1,14997980,01/05/2022,21.4,47688,25247,22441,17870,8920,8950
37,1,4989000,3,23641,1,3219209,01/05/2022,30.6,55931,28786,27145,18430,9082,9348
38,1,12946000,3,26636,1,8388264,01/05/2022,26.1,29018,15064,13954,10291,5191,5100
39,1,10168000,3,25789,1,6583411,01/05/2022,28.3,18219,9592,8627,5806,2838,2968
40,1,14347000,3,26522,1,9299028,01/05/2022,30.1,15244,8058,7186,4848,2429,2419
41,1,5144000,3,22865,1,3320735,01/05/2022,30.7,25366,13345,12021,7752,3823,3929
42,1,18322000,3,24287,1,11885013,01/05/2022,28.4,19271,9996,9275,6517,3095,3422
43,1,4700000,3,20554,1,3034446,01/05/2022,28.8,7662,4073,3589,2321,1153,1168
45,3,326931000,1,259091,3,212246059,01/05/2022,26.1,1501551,750157,751394,459910,225614,234296
46,3,123092000,1,180695,3,79829105,01/05/2022,26.4,925762,474776,450986,250961,123448,127513
47,2,33341000,3,51542,2,21620108,01/05/2022,29,128548,65838,62710,37721,18411,19310
48,1,27650000,3,41973,1,17930527,01/05/2022,22.2,135586,69677,65909,41627,20458,21169
49,2,35567000,2,56010,2,23062540,01/05/2022,26.4,113843,59214,54629,34117,16974,17143
50,1,6053000,3,22528,1,3911922,01/05/2022,29.7,23140,11693,11447,7155,3499,3656
51,1,10290000,3,24527,1,6663973,01/05/2022,24,35087,17902,17185,11563,5663,5900
52,1,13364000,3,34854,1,8651746,01/05/2022,27.7,42019,21548,20471,12599,6234,6365
53,1,10935000,3,29840,1,7077910,01/05/2022,29.3,22066,11231,10835,6719,3420,3299
54,1,8936000,3,21409,1,5786991,01/05/2022,15,17410,9121,8289,6393,3204,3189
55,1,2422000,3,23072,1,1551228,01/05/2022,30.5,22568,11549,11019,7200,3540,3660
56,1,6665000,3,24048,1,4308202,01/05/2022,20.2,15054,7516,7538,5557,2768,2789
57,1,3972000,2,71035,1,2510765,01/05/2022,24.4,8253,4210,4043,2801,1419,1382
58,1,5390000,3,36030,1,3467470,01/05/2022,19.6,7834,4065,3769,2439,1200,1239
59,1,2024000,3,27353,1,1288247,01/05/2022,14.4,14755,7617,7138,4907,2427,2480
60,1,13081000,3,30807,1,8471843,01/05/2022,22.6,62038,31762,30276,19262,9511,9751
61,3,111309000,1,120705,3,72230145,01/05/2022,30.9,690193,353744,336449,203574,99881,103693
62,3,159583000,1,181919,3,103547031,01/05/2022,25.6,864431,434753,429678,267728,131619,136109
63,2,52037000,2,64309,2,33759741,01/05/2022,31.8,237169,119538,117631,71348,35023,36325
64,2,58106000,2,75522,2,37693378,01/05/2022,27.6,173959,86825,87134,55826,27459,28367
65,1,11813000,3,25493,1,7652957,01/05/2022,29,39058,19755,19303,11201,5479,5722
66,3,127917000,1,180088,3,82965962,01/05/2022,29,59762,30506,29256,20025,9931,10094
67,1,17080000,3,36737,1,11065263,01/05/2022,30.7,49490,25496,23994,16916,8460,8456
68,2,33695000,2,53189,2,21848561,01/05/2022,28.6,160225,79799,80426,53549,26489,27060
69,1,20263000,3,16209,1,13154741,01/05/2022,25,114010,56192,57818,38156,18905,19251
70,1,28352000,3,42189,1,18386611,01/05/2022,28.3,75242,37695,37547,23792,11778,12014
71,1,14088000,3,25199,1,9132001,01/05/2022,29.8,59196,29915,29281,18125,8949,9176
72,1,17830000,3,27358,1,11562142,01/05/2022,30.1,32704,16713,15991,11320,5572,5748
73,1,8332000,3,25020,1,5390780,01/05/2022,29,23413,11884,11529,7157,3552,3605
74,1,10700000,3,24519,1,6930481,01/05/2022,29.1,38992,19602,19390,13022,6299,6723
75,1,1962000,3,18199,1,1257101,01/05/2022,31.5,27314,13703,13611,9005,4397,4608
76,2,58162000,2,67700,2,37737600,01/05/2022,27.2,146965,75962,71003,46271,22786,23485
77,2,31898000,3,42037,2,20691663,01/05/2022,28.5,88337,44762,43575,34686,17254,17432
78,2,47739000,2,65002,2,30965348,01/05/2022,26.5,159853,80569,79284,57402,28064,29338
79,1,2617000,3,22572,1,1678478,01/05/2022,27.9,9746,4912,4834,3336,1602,1734
80,1,2064000,3,24095,1,1317505,01/05/2022,27.7,15368,7632,7736,5699,2779,2920
81,1,1400000,3,9448,1,900552,01/05/2022,26.1,147496,76348,71148,49524,24280,25244
82,1,1178000,3,23998,1,741702,01/05/2022,26.7,14892,7420,7472,5365,2615,2750
83,1,8697000,3,25074,1,5627976,01/05/2022,29.2,34798,17459,17339,10865,5211,5654
84,2,44803000,1,184430,2,28937520,01/05/2022,22.8,432205,227255,204950,86717,42372,44345
85,2,46441000,1,172654,2,30013996,01/05/2022,22.1,759003,398068,360935,168014,83097,84917
86,3,104127000,1,319096,3,67363454,01/05/2022,22.7,1173351,609477,563874,261635,129105,132530
87,2,29466000,2,61809,2,19091091,01/05/2022,22.8,414470,219003,195467,75588,37198,38390
88,1,19217000,2,55434,1,12435616,01/05/2022,19.5,186693,97615,89078,46165,22603,23562
89,3,176705000,1,360285,3,114497965,01/05/2022,22.8,1835486,947835,887651,451632,222341,229291
90,2,60111000,1,112733,2,38959417,01/05/2022,22.4,614447,325337,289110,113945,55951,57994
91,2,29135000,2,85404,2,18852346,01/05/2022,22,434153,232032,202121,62030,30612,31418
92,2,59327000,1,122152,2,38440398,01/05/2022,20.8,323771,167274,156497,83659,40990,42669
93,2,49939000,2,80876,2,32379474,01/05/2022,20.8,404695,212343,192352,85496,42058,43438
94,1,27696000,1,149143,1,17853257,01/05/2022,21.6,443704,233586,210118,95713,47173,48540
95,2,70844000,1,270941,2,45777659,01/05/2022,21.5,545884,284933,260951,101794,50260,51534
96,1,17101000,2,57370,1,11058280,01/05/2022,20.6,429481,220393,209088,105785,52018,53767
97,1,9882000,3,47913,1,6375387,01/05/2022,16.8,246428,128767,117661,58169,28791,29378
98,1,13917000,3,29513,1,9016537,01/05/2022,16.8,599935,314284,285651,130174,64060,66114
99,3,133904000,1,162836,3,86874764,01/05/2022,24.9,616068,317266,298802,191866,94056,97810
100,2,80480000,2,81345,2,52230655,01/05/2022,24.1,301742,154079,147663,97495,48007,49488
101,1,11973000,3,20973,1,7761477,01/05/2022,28.3,96243,49040,47203,29383,14345,15038
102,1,18213000,3,30675,1,11807775,01/05/2022,23,30063,15334,14729,10450,5151,5299
103,1,1614000,2,92335,1,956765,01/05/2022,27,3222,1654,1568,1247,637,610
104,1,13337000,2,79832,1,8589218,01/05/2022,22,17967,9205,8762,6003,2945,3058
105,1,2498000,3,21600,1,1602100,01/05/2022,23,11943,6311,5632,3854,1993,1861
106,1,1945000,2,92899,1,1171351,01/05/2022,26.9,12850,6538,6312,4678,2267,2411
107,2,40486000,2,99151,2,26216749,01/05/2022,16,26678,13733,12945,10032,4897,5135
108,3,184752000,1,242632,3,119846168,01/05/2022,17.3,223876,119352,104524,50306,24928,25378
109,2,67162000,1,179195,2,43476105,01/05/2022,18.8,515353,266081,249272,126007,61695,64312
110,3,103919000,1,319022,3,67228328,01/05/2022,19.3,776220,402522,373698,193769,95439,98330
111,2,64295000,1,105518,2,41686232,01/05/2022,19.4,84298,43745,40553,23019,11356,11663
112,2,52193000,2,58267,2,33867183,01/05/2022,18.8,30929,15848,15081,8319,4034,4285
113,2,34090000,1,116168,2,22042332,01/05/2022,19.3,293245,152241,141004,70657,34731,35926
114,2,65139000,1,227279,2,42113071,01/05/2022,18.7,658907,338453,320454,150053,73914,76139
115,1,27002000,3,22210,1,17529090,01/05/2022,18.7,117995,60165,57830,29983,14851,15132
116,3,180229000,1,322210,3,116826640,01/05/2022,17.1,1643623,845932,797691,437489,216020,221469
117,2,76395000,1,154172,2,49502578,01/05/2022,23.8,368585,190133,178452,107535,52900,54635
118,2,48368000,2,65154,2,31374046,01/05/2022,11.4,174704,91497,83207,54449,28355,26094
119,1,21329000,3,45501,1,13818349,01/05/2022,9,2931,1520,1411,975,512,463
120,2,59008000,1,107131,2,38248069,01/05/2022,12.4,35491,18986,16505,7987,3993,3994
121,2,67393000,1,145400,2,43660050,01/05/2022,19.4,703215,359601,343614,230612,113552,117060
122,2,67765000,1,175518,2,43871732,01/05/2022,20.6,18226,9300,8926,5308,2603,2705
123,2,56881000,2,57832,2,36914818,01/05/2022,20.4,1072676,556998,515678,265425,131078,134347
124,1,23776000,3,19680,1,15434720,01/05/2022,24.6,14038,7254,6784,3763,1910,1853
125,2,72185000,2,83309,2,46836941,01/05/2022,11.4,174704,91497,83207,54449,28355,26094
126,2,55049000,3,32253,2,35749597,01/05/2022,17.3,7077,3593,3484,1748,893,855
127,2,38917000,2,52420,2,25243630,01/05/2022,18.5,53362,27304,26058,15169,7515,7654
128,1,17729000,3,19577,1,11504273,01/05/2022,7.3,24612,12254,12358,7339,3541,3798
129,2,51644000,1,175902,2,33392698,01/05/2022,21,10873,5623,5250,3757,1878,1879
130,2,57485000,2,58846,2,37306404,01/05/2022,16.5,23219,12339,10880,6425,3186,3239
131,1,26799000,3,37196,1,17382154,01/05/2022,20.6,12671,6512,6159,3454,1710,1744
132,1,21642000,3,31329,1,14035971,01/05/2022,15.6,30967,16277,14690,10756,5327,5429
133,2,43763000,2,55797,2,28390153,01/05/2022,21,323545,166328,157217,93932,46757,47175
134,1,6932000,3,18350,1,4487450,01/05/2022,26.1,19326,10155,9171,6252,3129,3123
135,1,22117000,3,35156,1,14340894,01/05/2022,11.4,33716,17686,16030,9317,4624,4693
136,1,13769000,3,49783,1,8900067,01/05/2022,18,40279,20716,19563,10282,5078,5204
137,1,3917000,3,21239,1,2524811,01/05/2022,19.5,29068,14916,14152,8580,4220,4360
138,2,30054000,2,55856,2,19479244,01/05/2022,21.1,12752,6694,6058,3471,1768,1703
139,1,5524000,3,48301,1,3542299,01/05/2022,17.5,33166,16973,16193,9497,4707,4790
140,1,6343000,3,11488,1,4111462,01/05/2022,18.7,52828,27143,25685,16500,8128,8372
141,2,32618000,3,24749,2,21176951,01/05/2022,17.8,32738,16941,15797,9059,4431,4628
142,1,11812000,3,24692,1,7653108,01/05/2022,19.5,30203,15792,14411,7568,3777,3791
143,2,32889000,3,37178,2,21340672,01/05/2022,18.7,11760,6069,5691,3432,1700,1732
144,1,11969000,3,19855,1,7759995,01/05/2022,20.4,72525,37076,35449,22128,10944,11184
145,1,8235000,3,26942,1,5325808,01/05/2022,9,18580,9729,8851,5724,2801,2923
146,1,20301000,3,28072,1,13167578,01/05/2022,20.6,24575,12798,11777,7126,3453,3673
147,1,1474000,3,20638,1,937462,01/05/2022,19.3,44731,22925,21806,13335,6514,6821
148,1,8934000,2,52448,1,5754652,01/05/2022,17.5,658907,338453,320454,150053,73914,76139
149,1,14252000,3,27228,1,9236572,01/05/2022,18.9,10336,5387,4949,3449,1664,1785
150,1,12316000,3,21498,1,7983902,01/05/2022,16.4,4656,2421,2235,1533,751,782
151,1,7069000,3,26178,1,4568672,01/05/2022,21,9598,5002,4596,2910,1467,1443
152,1,10781000,3,17890,1,6989760,01/05/2022,18.7,15171,7853,7318,4470,2251,2219
153,1,6000000,3,23492,1,3876508,01/05/2022,19.5,10792,5577,5215,3492,1713,1779
154,1,2227000,3,4333,1,1443217,01/05/2022,18.7,37442,19141,18301,12089,5963,6126
155,1,3273000,3,25989,1,2101461,01/05/2022,11.4,17736,9182,8554,5577,2775,2802
156,1,9322000,3,10308,1,6048992,01/05/2022,20.6,386290,199249,187041,112223,55337,56886
157,1,9083000,3,28211,1,5875739,01/05/2022,20.6,9925,5218,4707,2833,1403,1430
158,1,8866000,3,24016,1,5738884,01/05/2022,24.6,6944,3666,3278,2341,1149,1192
159,1,7676000,3,26746,1,4962654,01/05/2022,17.1,88734,45471,43263,28316,14166,14150
160,1,7991000,3,18653,1,5175497,01/05/2022,12.4,6449,3346,3103,1687,833,854
161,1,6559000,3,17467,1,4245883,01/05/2022,17,10735,5576,5159,3010,1518,1492
162,1,2911000,3,20115,1,1872035,01/05/2022,12.4,10810,5614,5196,2941,1451,1490
163,1,1295000,3,956,1,840794,01/05/2022,29.9,13038,6614,6424,4157,2015,2142
165,3,193026000,1,236832,3,125230068,01/05/2022,25.7,1579803,804212,775591,594938,292494,302444
166,2,81758000,2,68524,2,53074176,01/05/2022,22.4,378143,194849,183294,128863,62806,66057
167,2,78191000,2,65662,2,50758488,01/05/2022,23.4,452090,230346,221744,162764,80177,82587
168,1,24242000,3,35503,1,15721797,01/05/2022,25.1,69371,35473,33898,25304,12303,13001
169,2,31451000,3,46362,2,20396788,01/05/2022,23.5,79772,40908,38864,30907,15312,15595
170,1,25690000,3,38537,1,16659963,01/05/2022,24.2,56597,29703,26894,19146,9514,9632
171,1,24512000,3,31213,1,15901587,01/05/2022,23.8,72663,38036,34627,27395,13712,13683
172,2,51581000,2,80312,2,33447338,01/05/2022,24.3,160682,83178,77504,52342,25860,26482
173,2,32748000,3,35793,2,21250407,01/05/2022,22.6,83352,42766,40586,32937,16375,16562
174,2,33399000,3,34486,2,21674864,01/05/2022,22.1,67101,35567,31534,27008,13393,13615
175,1,17090000,3,34404,1,11074096,01/05/2022,23.4,43249,22352,20897,17065,8284,8781
176,1,26658000,3,40206,1,17287494,01/05/2022,21.9,51894,27702,24192,20579,10113,10466
177,1,24440000,3,48888,1,15837112,01/05/2022,24.5,70068,36526,33542,21044,10402,10642
178,1,20963000,3,25455,1,13600495,01/05/2022,22.8,52156,27081,25075,17108,8394,8714
179,1,3749000,3,24988,1,2411862,01/05/2022,22.3,41910,21741,20169,12631,6146,6485
180,1,24592000,3,49603,1,15935197,01/05/2022,23,43998,23109,20889,17575,8775,8800
181,1,5554000,3,25186,1,3584914,01/05/2022,26.3,24757,12827,11930,9816,4898,4918
182,1,4132000,3,18536,1,2667264,01/05/2022,23.1,21756,11234,10522,8659,4317,4342
183,1,8195000,3,10308,1,5316442,01/05/2022,23,28109,14419,13690,10548,5187,5361
184,1,6239000,3,23416,1,4031934,01/05/2022,27,15305,7996,7309,5899,2872,3027
185,1,27590000,3,38030,1,17895470,01/05/2022,23.2,72452,38019,34433,23628,11618,12010
186,1,19228000,3,24473,1,12473727,01/05/2022,23.9,35401,18444,16957,12235,5945,6290
187,2,29507000,3,37607,2,19141943,01/05/2022,23.4,27593,14289,13304,10803,5260,5543
188,1,21123000,3,23416,1,13706534,01/05/2022,23.8,31264,16171,15093,9806,4840,4966
189,1,20415000,3,35852,1,13233898,01/05/2022,19.7,24228,12861,11367,9383,4674,4709
190,1,22351000,3,25246,1,14502904,01/05/2022,20.2,32831,17049,15782,13856,6706,7150
191,1,2990000,3,23386,1,1920114,01/05/2022,25,16092,8507,7585,6837,3451,3386
192,1,8261000,3,27728,1,5341922,01/05/2022,22.7,8011,4268,3743,3134,1562,1572
193,1,14710000,3,25973,1,9535527,01/05/2022,26.6,29002,14796,14206,11206,5550,5656
194,1,3045000,3,26522,1,1952728,01/05/2022,21.6,7946,4172,3774,3293,1607,1686
195,1,12392000,3,9472,1,8045328,01/05/2022,24.7,28260,14728,13532,11002,5473,5529
196,1,6555000,3,5449,1,4255301,01/05/2022,23.8,25845,13471,12374,9370,4627,4743
197,3,146383000,1,181651,3,94967299,01/05/2022,28.3,658609,345979,312630,183298,90145,93153
198,2,55831000,2,57456,2,36232694,01/05/2022,24.6,225728,119129,106599,71494,35347,36147
199,2,34120000,3,43555,2,22134445,01/05/2022,31.3,70760,36613,34147,21788,10705,11083
200,2,44053000,2,79486,2,28554964,01/05/2022,30.7,132854,69610,63244,41183,20301,20882
201,1,19165000,2,55909,1,12401341,01/05/2022,23.2,50399,26542,23857,14000,6918,7082
202,1,2840000,3,26266,1,1819734,01/05/2022,26.2,27944,14419,13525,9490,4664,4826
203,1,6526000,3,26677,1,4215223,01/05/2022,20.9,22534,11802,10732,7926,3939,3987
204,1,13899000,3,29006,1,9005344,01/05/2022,26.8,25148,13436,11712,8928,4476,4452
205,1,25916000,3,27955,1,16817445,01/05/2022,24,33783,18241,15542,12201,6089,6112
206,2,33594000,3,28099,2,21808001,01/05/2022,32.6,25850,13268,12582,8390,4048,4342
208,2,35311000,3,37265,2,22914885,01/05/2022,20.5,27607,14605,13002,9883,5002,4881
209,1,9571000,3,27125,1,6194025,01/05/2022,27.6,13866,7187,6679,4383,2099,2284
210,1,7453000,3,25937,1,4818513,01/05/2022,27,23363,12127,11236,7776,3818,3958
211,1,15435000,3,31022,1,10001728,01/05/2022,26.5,18224,9500,8724,7072,3514,3558
212,1,14932000,3,24497,1,9681303,01/05/2022,28.8,16447,8464,7983,4843,2381,2462
213,1,5839000,3,14021,1,3781329,01/05/2022,26.7,17550,9283,8267,5700,2861,2839
214,2,72034000,1,152956,2,46669144,01/05/2022,19.8,297848,156299,141549,74787,37046,37741
215,2,30385000,3,20033,2,19730217,01/05/2022,21.4,29390,15521,13869,7939,3942,3997
216,2,36066000,2,66909,2,23375991,01/05/2022,22.4,37608,20094,17514,11115,5490,5625
217,2,39331000,2,68632,2,25496518,01/05/2022,21.6,106163,56161,50002,30752,15034,15718
218,1,14777000,3,24249,1,9580801,01/05/2022,18.4,11149,5894,5255,2996,1479,1517
219,2,39163000,3,51520,2,25404430,01/05/2022,16.8,60265,30945,29320,18808,9224,9584
220,1,21226000,3,31183,1,13765717,01/05/2022,22.1,17718,9411,8307,4913,2492,2421
221,1,19376000,3,30918,1,12563482,01/05/2022,20.9,36618,19077,17541,10530,5273,5257
222,1,12169000,3,23164,1,7886686,01/05/2022,24.3,9853,5224,4629,2757,1390,1367
223,1,2995000,3,25996,1,1920754,01/05/2022,21.4,27713,14561,13152,7736,3885,3851
224,1,7038000,3,23778,1,4550922,01/05/2022,20.8,32276,17014,15262,9457,4578,4879
225,1,8851000,3,23519,1,5729631,01/05/2022,24.3,14689,7582,7107,4123,2033,2090
226,2,40432000,3,46720,2,26234080,01/05/2022,26.5,44311,23331,20980,13756,6771,6985
227,1,4828000,3,24976,1,3113224,01/05/2022,24.5,14732,7791,6941,4911,2433,2478
228,1,11774000,3,24573,1,7628527,01/05/2022,20.3,20530,10890,9640,6356,3180,3176
229,1,13898000,3,23072,1,9010628,01/05/2022,29.2,16368,8558,7810,4728,2323,2405
230,1,8787000,3,23778,1,5687772,01/05/2022,17.6,6213,3216,2997,1786,871,915
231,1,11102000,3,22660,1,7193640,01/05/2022,16.8,28792,15288,13504,8327,4111,4216
233,1,5032000,3,6731,1,3264069,01/05/2022,23.3,8657,4501,4156,2464,1200,1264
234,2,72166000,1,108588,2,46799312,01/05/2022,25.1,224166,112147,112019,65088,31954,33134
235,2,29805000,2,65648,2,19307602,01/05/2022,22.9,111569,57370,54199,36412,17892,18520
236,1,26662000,3,32249,1,17298051,01/05/2022,25,38780,20122,18658,13025,6461,6564
237,3,164790000,1,335996,3,106777504,01/05/2022,24.5,1385621,718628,666993,333198,164217,168981
238,3,112524000,1,245680,3,72894920,01/05/2022,23.3,1257547,645398,612149,321993,158559,163434
239,1,22093000,3,30686,1,14329764,01/05/2022,24.6,37871,19554,18317,11359,5732,5627
240,2,91002000,1,193836,2,58957464,01/05/2022,27,650123,329365,320758,200033,98558,101475
241,2,42732000,2,67246,2,27708554,01/05/2022,23.7,111975,57735,54240,31481,15460,16021
242,1,14784000,3,24741,1,9584859,01/05/2022,25,98842,50427,48415,30938,15263,15675
243,2,70492000,1,184699,2,45635101,01/05/2022,23.8,44103,22420,21683,15768,7755,8013
244,1,11530000,3,27364,1,7467136,01/05/2022,22,53539,27205,26334,18000,8916,9084
245,1,11194000,3,26654,1,7249446,01/05/2022,26.5,18787,9476,9311,6502,3270,3232
246,1,16713000,3,36276,1,10827174,01/05/2022,25,59648,30609,29039,19344,9536,9808
247,2,61326000,2,102470,2,39759430,01/05/2022,23.7,30471,15635,14836,9610,4654,4956
248,1,4318000,3,25526,1,2781174,01/05/2022,25.3,20286,10307,9979,6804,3413,3391
249,1,4156000,3,23082,1,2678318,01/05/2022,25.8,20345,10131,10214,6733,3300,3433
250,1,21797000,3,38265,1,14129785,01/05/2022,25,31115,15891,15224,10525,5240,5285
251,1,14412000,3,44985,1,9322815,01/05/2022,25.3,16550,8456,8094,5252,2552,2700
252,1,17562000,3,25464,1,11389836,01/05/2022,25.4,24352,12627,11725,8092,4062,4030
253,1,21894000,3,38136,1,14192964,01/05/2022,22.6,94978,48709,46269,29794,14672,15122
254,1,24877000,3,29684,1,16140366,01/05/2022,25.7,52019,26739,25280,15725,7759,7966
255,1,4112000,3,23942,1,2648858,01/05/2022,25,24580,12765,11815,8215,4057,4158
256,1,14396000,3,25013,1,9332387,01/05/2022,24.5,28678,14679,13999,9074,4497,4577
257,1,4044000,3,23778,1,2604822,01/05/2022,19.2,22738,11719,11019,7000,3537,3463
258,1,11177000,3,24908,1,7240142,01/05/2022,23.7,28145,14670,13475,8863,4390,4473
259,1,9582000,3,28323,1,6199977,01/05/2022,23.7,19113,9852,9261,5504,2716,2788
260,1,1987000,3,23548,1,1268002,01/05/2022,22,25925,13382,12543,8585,4189,4396
261,1,950000,3,23548,1,593952,01/05/2022,24.5,13033,6697,6336,4420,2181,2239
262,1,2786000,3,24039,1,1786861,01/05/2022,14.2,5955,3118,2837,1972,974,998
263,1,1683000,3,20294,1,1073656,01/05/2022,25,8850,4524,4326,2773,1377,1396
264,1,2463000,3,21962,1,1578988,01/05/2022,19.2,9529,4943,4586,3018,1490,1528
265,1,10160000,3,27429,1,6576571,01/05/2022,22,14636,7533,7103,4910,2424,2486
266,1,19421000,3,34401,1,12589249,01/05/2022,25.3,40906,20800,20106,12864,6409,6455
267,1,6609000,3,25333,1,4270517,01/05/2022,23.7,8142,4289,3853,2686,1333,1353
268,1,1906000,3,22919,1,1215981,01/05/2022,19.2,7954,4060,3894,2570,1274,1296
269,1,11936000,3,24819,1,7733581,01/05/2022,25,17000,8527,8473,5215,2549,2666
270,1,3764000,3,23204,1,2423396,01/05/2022,21.6,14424,7439,6985,5399,2678,2721
271,1,2563000,3,23316,1,1642634,01/05/2022,25,16873,8725,8148,6022,3008,3014
272,1,2990000,3,19230,1,1924270,01/05/2022,23.7,5109,2618,2491,1631,805,826
273,1,2548000,3,23390,1,1632810,01/05/2022,23.7,13243,6795,6448,4043,1954,2089
274,1,2446000,3,21864,1,1568036,01/05/2022,22,14497,7627,6870,4260,2099,2161
275,1,2323000,3,19551,1,1490399,01/05/2022,25.4,16324,8373,7951,5562,2774,2788
276,1,5115000,3,24909,1,3299841,01/05/2022,26.7,9842,5047,4795,3323,1629,1694
277,1,3562000,3,22080,1,2293220,01/05/2022,22,27833,14525,13308,9097,4581,4516
278,1,4813000,3,5252,1,3123198,01/05/2022,25.6,33284,17172,16112,10804,5349,5455
279,1,2140000,3,22274,1,1368726,01/05/2022,24.8,14697,7601,7096,4740,2380,2360
280,1,4588000,3,19309,1,2962891,01/05/2022,22.6,18607,9363,9244,6403,3178,3225
284,3,115108000,1,166112,3,74654088,01/05/2022,28.5,743275,388114,355161,202467,99875,102592
285,2,42616000,2,91053,2,27609347,01/05/2022,19.7,154546,80401,74145,48513,24003,24510
286,2,73424000,2,101407,2,47624193,01/05/2022,21.6,299523,155411,144112,93845,46362,47483
287,2,47783000,2,64590,2,30994360,01/05/2022,27.3,83637,42325,41312,24783,12286,12497
288,2,42818000,2,69076,2,27762624,01/05/2022,31,102362,52461,49901,35162,17416,17746
289,1,18063000,3,36492,1,11704458,01/05/2022,24.3,55287,28877,26410,16959,8447,8512
290,1,22787000,3,39617,1,14771933,01/05/2022,26,87042,45232,41810,26414,12958,13456
291,2,38223000,2,58368,2,24786582,01/05/2022,14.3,86901,45620,41281,26262,13160,13102
292,1,23894000,3,24103,1,15506997,01/05/2022,24.5,30519,15931,14588,10809,5325,5484
293,2,34514000,3,36978,2,22397122,01/05/2022,21.4,60811,31893,28918,19713,9706,10007
294,1,3627000,3,10416,1,2347134,01/05/2022,20.5,61510,31765,29745,21000,10487,10513
295,1,24310000,3,50527,1,15750973,01/05/2022,19.6,70042,36241,33801,21818,10809,11009
296,1,4877000,3,9783,1,3160267,01/05/2022,18.9,24662,12965,11697,6937,3350,3587
297,1,6257000,3,20609,1,4046441,01/05/2022,20.5,15414,7999,7415,4635,2291,2344
298,1,25438000,3,24583,1,16510117,01/05/2022,20.4,71528,37497,34031,23278,11539,11739
299,1,2360000,3,24586,1,1509414,01/05/2022,24.5,15249,7932,7317,4894,2453,2441
300,2,29429000,3,25726,2,19103124,01/05/2022,21.2,39425,20578,18847,13203,6477,6726
301,1,3839000,3,25807,1,2469543,01/05/2022,18.9,17293,8766,8527,5650,2795,2855
302,1,13146000,3,25789,1,8519111,01/05/2022,14.3,16905,8772,8133,5514,2740,2774
303,1,3669000,3,23434,1,2361416,01/05/2022,21.4,18097,9360,8737,5881,2892,2989
304,1,14823000,3,25732,1,9609218,01/05/2022,25,32333,16690,15643,10314,5057,5257
305,1,20069000,3,27125,1,13017725,01/05/2022,23.7,49940,25545,24395,16071,7998,8073
306,1,18149000,3,26922,1,11769928,01/05/2022,20.6,1049,546,503,282,149,133
307,1,15521000,3,25789,1,10062861,01/05/2022,22.7,6853,3584,3269,2311,1149,1162
308,1,7467000,3,5049,1,4848501,01/05/2022,29.9,12262,6119,6143,4251,2104,2147
309,1,2458000,3,28828,1,1568872,01/05/2022,23.7,11086,5609,5477,3615,1780,1835
310,1,2574000,3,27360,1,1645740,01/05/2022,26,13821,7083,6738,3938,1966,1972
311,2,54897000,1,141592,2,35541458,01/05/2022,26.8,341029,180370,160659,82444,40670,41774
312,2,76979000,2,98225,2,49938125,01/05/2022,27,157336,82380,74956,43883,21497,22386
313,1,24892000,3,10391,1,16169409,01/05/2022,30.1,174629,91268,83361,46521,22880,23641
314,2,34298000,3,47108,2,22246592,01/05/2022,28,104461,54150,50311,30967,15315,15652
315,1,17102000,3,48945,1,11067355,01/05/2022,26.9,44353,23038,21315,13070,6400,6670
316,1,5107000,3,25928,1,3293622,01/05/2022,29.9,21375,11206,10169,5662,2753,2909
317,2,35516000,3,41500,2,23043900,01/05/2022,29.9,17777,9225,8552,4254,2086,2168
318,2,42398000,2,93987,2,27464713,01/05/2022,30.1,64084,32934,31150,19785,9668,10117
319,1,15427000,3,27133,1,10000417,01/05/2022,29.2,20434,10867,9567,5939,2970,2969
320,1,15700000,3,27023,1,10177977,01/05/2022,20.7,19085,9763,9322,6343,3119,3224
321,2,99985000,1,124192,2,64866058,01/05/2022,22.4,371387,192530,178857,106784,52432,54352
322,1,21338000,3,21724,1,13847976,01/05/2022,25.6,18023,9240,8783,5154,2503,2651
323,1,14435000,3,45686,1,9337064,01/05/2022,25.4,20322,10479,9843,6201,3025,3176
324,1,20055000,3,33359,1,13002391,01/05/2022,25.4,25477,13300,12177,8208,4059,4149
325,1,9678000,3,51433,1,6239267,01/05/2022,27.7,13620,7015,6605,4098,1994,2104
326,1,13724000,3,24343,1,8896257,01/05/2022,25.4,48170,25016,23154,15515,7657,7858
327,1,9381000,3,49299,1,6048351,01/05/2022,29.8,10593,5340,5253,3485,1705,1780
328,2,40440000,2,74978,2,26211022,01/05/2022,25.6,8730,4395,4335,2894,1447,1447
329,1,4351000,3,23778,1,2804372,01/05/2022,28.3,14678,7367,7311,4863,2405,2458
330,1,8550000,3,24364,1,5533136,01/05/2022,25.6,10935,5450,5485,3532,1706,1826
331,1,10883000,3,23736,1,7050214,01/05/2022,28.6,19976,10345,9631,6431,3120,3311
332,2,67505000,2,100844,2,43777406,01/05/2022,30.1,412199,209241,202958,82879,40585,42294
333,2,67517000,1,122547,2,43763503,01/05/2022,30.1,304052,152635,151417,84118,41457,42661
334,3,101573000,1,139567,3,65882883,01/05/2022,27.6,536436,267279,269157,158598,77797,80801
335,3,134154000,1,144909,3,87055191,01/05/2022,27.6,635862,320627,315235,153834,75737,78097
336,3,162873000,1,210766,3,105656684,01/05/2022,28.8,1142952,578172,564780,270109,132170,137939
338,1,17672000,3,47621,1,11439179,01/05/2022,27.6,75721,38037,37684,21903,10795,11108
339,1,20434000,3,35327,1,13246773,01/05/2022,32.4,70378,35870,34508,21367,10464,10903
340,2,50420000,3,25387,2,32747613,01/05/2022,20.8,308285,152976,155309,108145,53196,54949
342,2,50437000,2,63207,2,32720843,01/05/2022,26.2,234698,115478,119220,87040,43098,43942
343,1,14002000,3,27598,1,9073702,01/05/2022,27.6,28843,14318,14525,8529,4190,4339
344,1,12829000,3,25382,1,8313468,01/05/2022,29.2,33522,17126,16396,9330,4711,4619
345,1,18164000,3,48417,1,11758183,01/05/2022,29.4,54467,27606,26861,15858,7789,8069
346,1,20343000,3,21202,1,13201748,01/05/2022,30.1,13059,6525,6534,4137,2073,2064
347,1,1467000,3,4601,1,948949,01/05/2022,20.8,9934,4952,4982,3082,1558,1524
348,1,5149000,3,25613,1,3321237,01/05/2022,20.8,7844,4131,3713,2621,1355,1266
349,1,10769000,3,49186,1,6950664,01/05/2022,27.6,48069,23121,24948,16392,8040,8352
350,1,13021000,3,20779,1,8442871,01/05/2022,30.1,11583,5810,5773,3713,1872,1841
351,1,3259000,3,20626,1,2097724,01/05/2022,29,29903,15539,14364,9778,4798,4980
352,3,143667000,1,257095,3,93126455,01/05/2022,26.9,258913,138803,120110,68042,33683,34359
353,2,53007000,2,81978,2,34372572,01/05/2022,30.5,103609,54904,48705,31555,15575,15980
354,1,28048000,2,73849,1,18157351,01/05/2022,30.1,76660,40113,36547,21596,10646,10950
355,2,37003000,3,50099,2,24001851,01/05/2022,29.5,88280,46038,42242,25864,12608,13256
356,2,30009000,2,58673,2,19447177,01/05/2022,24.6,56163,29689,26474,18214,8872,9342
357,1,2602000,3,29972,1,1661328,01/05/2022,30.5,7263,3837,3426,2540,1279,1261
358,1,16806000,3,24446,1,10899454,01/05/2022,28.6,16645,8759,7886,5075,2484,2591
359,1,14657000,2,52389,1,9474661,01/05/2022,29.6,31469,16729,14740,9837,4899,4938
360,1,14207000,3,24536,1,9210014,01/05/2022,19.2,12729,6935,5794,4541,2296,2245
361,1,12691000,3,26970,1,8222180,01/05/2022,29.5,26015,13735,12280,7360,3633,3727
362,2,40997000,3,30939,2,26617111,01/05/2022,29,29903,15539,14364,9778,4798,4980
363,1,24580000,3,35776,1,15941224,01/05/2022,28.4,10504,5405,5099,3440,1722,1718
364,1,17535000,3,26001,1,11371749,01/05/2022,30.8,45134,23442,21692,13494,6690,6804
365,1,21937000,3,49967,1,14209083,01/05/2022,22.5,29130,15431,13699,9957,5019,4938
366,1,5638000,3,20162,1,3644538,01/05/2022,30.6,5812,3105,2707,1767,906,861
367,1,14429000,3,25769,1,9353081,01/05/2022,19.2,15851,8463,7388,5625,2839,2786
368,1,5247000,3,23678,1,3386872,01/05/2022,22.5,15298,8185,7113,4499,2268,2231
369,1,27205000,3,28641,1,17654609,01/05/2022,29.5,17525,9370,8155,5075,2488,2587
370,1,20600000,2,71811,1,13318189,01/05/2022,19.2,18915,10248,8667,6395,3217,3178
371,1,23494000,3,22318,1,15248782,01/05/2022,24.3,81848,43535,38313,23849,11894,11955
372,2,37504000,3,36913,2,24340687,01/05/2022,24.5,33726,17513,16213,11096,5372,5724
373,1,2236000,3,20638,1,1432762,01/05/2022,22.5,11168,5931,5237,3889,1954,1935
374,1,5471000,3,24547,1,3531603,01/05/2022,30.5,6341,3343,2998,2049,979,1070
375,1,22428000,3,13777,1,14564423,01/05/2022,24.3,45895,23816,22079,12162,5997,6165
376,1,6452000,3,39009,1,4154791,01/05/2022,30,6863,3664,3199,2612,1321,1291
377,1,10699000,3,25855,1,6928495,01/05/2022,24.5,10611,5602,5009,3876,1871,2005
378,1,3884000,3,25577,1,2499023,01/05/2022,28.6,14226,7514,6712,4380,2214,2166
379,1,5380000,3,20404,1,3476596,01/05/2022,24.3,7997,4114,3883,2359,1161,1198
380,1,4100000,3,9473,1,2655527,01/05/2022,29.6,4188,2243,1945,1509,761,748
381,2,29722000,2,57011,2,19262289,01/05/2022,29,15373,8115,7258,5203,2638,2565
382,1,15932000,3,23023,1,10332777,01/05/2022,29.2,14071,7408,6663,4497,2251,2246
383,1,1957000,3,20393,1,1251657,01/05/2022,18.4,6642,3720,2922,2058,1005,1053
384,1,7329000,3,6092,1,4757758,01/05/2022,30.2,11054,5638,5416,3563,1745,1818
385,3,228483000,1,421855,3,148092095,01/05/2022,21.4,1542232,806262,735970,402209,198130,204079
386,2,48871000,2,63007,2,31703143,01/05/2022,19.2,78264,40929,37335,23163,11368,11795
387,2,63395000,2,78707,2,41128043,01/05/2022,23.7,293825,155300,138525,93203,46206,46997
388,2,30276000,3,44437,2,19634963,01/05/2022,28.2,49578,26095,23483,16381,8171,8210
389,2,38230000,3,37616,2,24811884,01/05/2022,22.9,89314,47398,41916,25892,12760,13132
390,2,43611000,3,34006,2,28313144,01/05/2022,20.4,31315,16320,14995,10348,5100,5248
391,1,20616000,3,50079,1,13350321,01/05/2022,16.9,39203,20881,18322,12964,6446,6518
392,1,21838000,3,50154,1,14144546,01/05/2022,22.4,58957,31503,27454,19229,9506,9723
393,2,37665000,2,84784,2,24397466,01/05/2022,18.1,62849,33939,28910,17954,8876,9078
394,1,20178000,3,35172,1,13080528,01/05/2022,17.4,25468,13582,11886,8293,4136,4157
395,1,22366000,3,46373,1,14491527,01/05/2022,16.9,31599,16595,15004,11708,5967,5741
396,2,29904000,2,52457,2,19385143,01/05/2022,16.9,29123,15247,13876,9589,4733,4856
397,1,17166000,3,26950,1,11130950,01/05/2022,18.9,18110,9443,8667,6325,3046,3279
398,1,11876000,3,39531,1,7679869,01/05/2022,16.9,31695,16422,15273,11280,5582,5698
399,1,18033000,3,33950,1,11687500,01/05/2022,16.9,95322,48884,46438,32521,16133,16388
400,1,13362000,3,28849,1,8656451,01/05/2022,16.9,9358,5013,4345,2738,1323,1415
401,1,12972000,3,48178,1,8383622,01/05/2022,19.2,9149,4948,4201,2691,1357,1334
402,1,3774000,3,22963,1,2430137,01/05/2022,16.9,9913,5282,4631,3496,1711,1785
403,1,11145000,3,9921,1,7234329,01/05/2022,16.9,36620,18819,17801,10303,4961,5342
404,1,1937000,3,24198,1,1234852,01/05/2022,16.9,5276,2719,2557,1830,893,937
405,1,18871000,3,27125,1,12239025,01/05/2022,16.9,41455,21994,19461,13993,6843,7150
406,1,16022000,3,24020,1,10390280,01/05/2022,20.1,29613,15403,14210,9414,4672,4742
408,1,11249000,3,23416,1,7288434,01/05/2022,18.7,13922,7166,6756,5211,2590,2621
409,1,3747000,3,21961,1,2413589,01/05/2022,16.9,10960,5789,5171,3556,1785,1771
410,1,13479000,3,27125,1,8734225,01/05/2022,15.6,22904,12086,10818,7644,3743,3901
411,1,8040000,3,23501,1,5202499,01/05/2022,16.9,11776,6077,5699,3730,1832,1898
412,1,1788000,3,9087,1,1153113,01/05/2022,16.9,16797,8560,8237,5425,2652,2773
413,1,3501000,3,23548,1,2252102,01/05/2022,16.9,19648,10052,9596,6751,3334,3417
414,1,14931000,3,27088,1,9678062,01/05/2022,27.7,19341,10302,9039,6428,3158,3270
415,1,3273000,3,25438,1,2102012,01/05/2022,18.2,11487,6208,5279,3749,1855,1894
416,1,5437000,3,18323,1,3515727,01/05/2022,16.9,5703,2985,2718,1959,971,988
417,1,2100000,3,20153,1,1344847,01/05/2022,16.9,6644,3435,3209,2305,1130,1175
418,1,3424000,3,15214,1,2210386,01/05/2022,16.9,7491,3982,3509,2583,1266,1317
419,1,1817000,3,12628,1,1168422,01/05/2022,16.9,8481,4360,4121,2849,1391,1458
420,1,23120000,3,37249,1,14990751,01/05/2022,20.6,46996,24240,22756,12187,6012,6175
421,1,2828000,3,20394,1,1817806,01/05/2022,23.6,8445,4468,3977,3005,1505,1500
422,1,6048000,3,21364,1,3909836,01/05/2022,20.1,5612,3027,2585,1851,938,913
423,1,6977000,3,24064,1,4510986,01/05/2022,28.7,5276,2719,2557,1830,893,937
424,3,188903000,1,241843,3,122545107,01/05/2022,23.3,794789,407239,387550,199480,98049,101431
425,2,46688000,2,60273,2,30286927,01/05/2022,20.4,177719,91525,86194,50219,24680,25539
426,1,19178000,3,27468,1,12438232,01/05/2022,20.4,34955,18206,16749,9854,4805,5049
427,1,2098000,3,21869,1,1341831,01/05/2022,20.2,115264,60166,55098,28758,14392,14366
428,1,15359000,3,24408,1,9958942,01/05/2022,20.4,16795,8697,8098,5436,2628,2808
429,1,6624000,3,23434,1,4282166,01/05/2022,23.7,13390,6831,6559,4033,1966,2067
430,1,8280000,3,23943,1,5358057,01/05/2022,23.7,7953,4224,3729,2375,1195,1180
431,1,7377000,3,18499,1,4776551,01/05/2022,30.2,15512,8121,7391,5093,2493,2600
432,2,56643000,3,48762,2,36769188,01/05/2022,29.7,169028,86790,82238,45879,22689,23190
433,3,159941000,1,158048,3,103803602,01/05/2022,29.6,888797,441181,447616,247410,121384,126026
434,2,71885000,2,74218,2,46651032,01/05/2022,27.6,304942,149380,155562,85665,42398,43267
435,1,26205000,2,53585,1,16979665,01/05/2022,29.7,84519,42292,42227,24955,12440,12515
436,1,16645000,3,23072,1,10796178,01/05/2022,28.9,30754,15948,14806,10320,5221,5099
437,3,150152000,1,131645,3,97467155,01/05/2022,23.4,845941,437370,408571,227808,112567,115241
438,2,58282000,2,64454,2,37818846,01/05/2022,32.2,136351,71718,64633,38918,19062,19856
439,2,31330000,3,51425,2,20313075,01/05/2022,25.8,86686,44901,41785,27406,13467,13939
440,2,35467000,3,45684,2,23007866,01/05/2022,28.6,58158,30570,27588,17715,8934,8781
441,1,27393000,2,67488,1,17737962,01/05/2022,30.2,24258,12834,11424,7258,3602,3656
442,1,13200000,3,26416,1,8553584,01/05/2022,30.5,24454,12691,11763,7326,3576,3750
443,1,23791000,3,29537,1,15434613,01/05/2022,23.8,310192,159130,151062,94872,46787,48085
444,1,3121000,3,25505,1,2003145,01/05/2022,23.9,14340,7646,6694,4731,2430,2301
445,2,62189000,2,72461,2,40350389,01/05/2022,30.5,15341,8078,7263,4842,2416,2426
446,1,4618000,3,25575,1,2976125,01/05/2022,30.2,8045,4283,3762,2501,1247,1254
447,1,10162000,3,25493,1,6579807,01/05/2022,30.2,6644,3540,3104,2086,1058,1028
448,1,4026000,3,22174,1,2594726,01/05/2022,30.5,16582,8647,7935,5030,2477,2553
449,1,26890000,2,66605,1,17411895,01/05/2022,27,30796,15740,15056,9239,4503,4736
450,2,66214000,2,80776,2,42958324,01/05/2022,26.1,77849,40866,36983,21990,10871,11119
451,2,34929000,3,38281,2,22665569,01/05/2022,27.5,65215,33971,31244,19700,9733,9967
452,3,126449000,1,144550,3,82047300,01/05/2022,24.1,441975,227109,214866,122010,60145,61865
453,3,292957000,1,253398,3,190168652,01/05/2022,27.9,808416,416251,392165,234633,115277,119356
454,2,93053000,1,135218,2,60349232,01/05/2022,28,298009,154344,143665,83869,41238,42631
455,1,16737000,3,21866,1,10857184,01/05/2022,28.5,33924,17240,16684,10629,5267,5362
456,1,12790000,3,30470,1,8283030,01/05/2022,26.2,14772,7516,7256,4444,2199,2245
457,1,20867000,3,30830,1,13532720,01/05/2022,26.8,19742,9908,9834,6831,3367,3464
458,1,11283000,3,30241,1,7303709,01/05/2022,29.7,12848,6693,6155,3711,1831,1880
459,1,11500000,3,25214,1,7449786,01/05/2022,27,5457,2839,2618,1473,755,718
460,1,6745000,3,26765,1,4357485,01/05/2022,27.1,5926,3043,2883,1700,842,858
461,1,11673000,3,26419,1,7561031,01/05/2022,28.5,17097,8801,8296,5359,2662,2697
462,1,16123000,2,52431,1,10427519,01/05/2022,27,28239,14113,14126,8795,4312,4483
463,1,11933000,3,22952,1,7733498,01/05/2022,25.2,16934,8502,8432,5395,2626,2769
464,1,14009000,3,50705,1,9055145,01/05/2022,25.9,11851,5973,5878,3739,1841,1898
465,1,6963000,3,24815,1,4501135,01/05/2022,28.2,25157,12582,12575,8765,4230,4535
466,1,3188000,3,22492,1,2049708,01/05/2022,29.8,6055,3107,2948,1652,803,849
467,1,3226000,3,23773,1,2073127,01/05/2022,28.2,22421,11364,11057,6263,3134,3129
468,1,1937000,3,23778,1,1235272,01/05/2022,25.2,9864,5093,4771,3123,1529,1594
469,1,3304000,3,19424,1,2128176,01/05/2022,26.3,7888,4037,3851,3058,1509,1549
470,1,5268000,3,26151,1,3398049,01/05/2022,27,5524,2885,2639,1817,894,923
472,1,3194000,3,36137,1,2039963,01/05/2022,31.9,10328,5288,5040,3690,1794,1896
473,1,1087000,3,2794,1,703756,01/05/2022,26.3,4810,2229,2581,1556,759,797
474,2,88338000,1,137326,2,57282374,01/05/2022,28.7,329404,168547,160857,90108,44605,45503
475,3,165387000,1,268679,3,107232871,01/05/2022,28.7,855563,431621,423942,240318,117646,122672
476,2,35448000,2,69280,2,22971920,01/05/2022,25.4,117253,59414,57839,33098,16300,16798
477,2,64451000,2,61696,2,41831454,01/05/2022,26.9,176685,87738,88947,53884,26504,27380
478,2,71958000,1,123500,2,46649200,01/05/2022,23.6,261137,131158,129979,84004,41439,42565
479,2,39949000,3,50669,2,25916181,01/05/2022,28,120926,61958,58968,34805,17098,17707
480,1,27747000,3,35450,1,18000100,01/05/2022,25.7,67604,34141,33463,21101,10330,10771
481,1,13844000,3,23072,1,8975528,01/05/2022,25.6,38886,19733,19153,11641,5731,5910
482,1,15606000,3,24386,1,10119514,01/05/2022,24.7,30324,15540,14784,8298,4088,4210
483,2,31602000,3,35373,2,20505927,01/05/2022,23.5,91029,45722,45307,30379,15003,15376
484,1,25946000,3,27659,1,16837241,01/05/2022,25.4,62301,30877,31424,20494,10127,10367
485,1,3365000,3,21953,1,2165297,01/05/2022,25.1,12987,6460,6527,4296,2156,2140
486,1,24793000,3,27311,1,16088139,01/05/2022,22.6,38113,19225,18888,12385,6138,6247
487,1,2024000,3,23367,1,1292233,01/05/2022,28.5,12372,6340,6032,3845,1851,1994
488,1,13615000,3,22804,1,8826946,01/05/2022,24.9,39474,19169,20305,14904,7336,7568
489,1,13262000,3,27131,1,8593169,01/05/2022,24.8,30429,15578,14851,9786,4826,4960
490,1,5703000,3,27040,1,3679910,01/05/2022,24.1,13153,6653,6500,4059,2009,2050
491,1,5320000,3,26394,1,3431606,01/05/2022,24.5,11440,5836,5604,4121,2095,2026
492,1,2623000,3,25881,1,1679069,01/05/2022,24.4,4787,2437,2350,1357,684,673
493,3,103988000,1,160885,3,67431315,01/05/2022,28.9,340060,178122,161938,86078,42456,43622
494,2,46374000,3,40154,2,30102946,01/05/2022,30.2,43035,22773,20262,11996,6054,5942
495,1,22043000,3,35210,1,14292740,01/05/2022,31.3,27182,14325,12857,8434,4220,4214
496,1,16031000,3,25388,1,10394762,01/05/2022,30.2,21003,10909,10094,6452,3209,3243
497,1,24471000,3,34278,1,15871872,01/05/2022,30.6,31435,16316,15119,9125,4445,4680
498,1,17911000,3,42329,1,11599821,01/05/2022,30.4,29068,15153,13915,8638,4280,4358
499,1,21077000,3,22737,1,13677313,01/05/2022,30,25555,13197,12358,7191,3479,3712
500,1,6401000,3,11969,1,4148681,01/05/2022,30.5,13944,7272,6672,4420,2177,2243
501,1,20514000,3,21866,1,13312234,01/05/2022,29.8,34946,17956,16990,11208,5422,5786
502,1,13293000,3,22892,1,8617558,01/05/2022,30.4,16679,8618,8061,4633,2284,2349
503,2,69061000,2,82065,2,44807585,01/05/2022,29.2,297373,155718,141655,71865,35366,36499
504,3,167074000,1,194034,3,108404066,01/05/2022,26.9,691557,348387,343170,213267,104895,108372
505,2,90865000,2,71940,2,58990310,01/05/2022,30.5,416055,211059,204996,132268,65355,66913
506,1,21172000,3,33106,1,13728694,01/05/2022,29.2,111314,55902,55412,35576,17423,18153
507,2,71675000,2,94498,2,46494252,01/05/2022,30.5,332100,171749,160351,94911,46503,48408
508,2,33712000,3,42796,2,21870004,01/05/2022,31.6,79515,41903,37612,21445,10720,10725
509,2,34495000,2,54591,2,22367159,01/05/2022,28.7,205933,107685,98248,49242,24249,24993
510,1,15131000,3,24752,1,9810398,01/05/2022,29.3,48172,24667,23505,15031,7399,7632
511,1,12083000,3,24324,1,7829626,01/05/2022,29.2,18592,8945,9647,4116,2046,2070
512,2,33831000,3,40467,2,21949683,01/05/2022,29.3,79824,40689,39135,24808,12213,12595
513,1,2539000,3,20253,1,1630097,01/05/2022,29.2,10327,5388,4939,2996,1506,1490
514,1,8385000,3,19635,1,5430615,01/05/2022,29.2,28215,14347,13868,9384,4582,4802
515,1,6440000,3,6355,1,4179645,01/05/2022,30.5,10993,5737,5256,3544,1803,1741
517,1,27134000,3,40182,1,17596918,01/05/2022,17,53373,27810,25563,15744,7755,7989
518,2,35667000,2,76961,2,23106589,01/05/2022,19.7,13555,7357,6198,3051,1547,1504
519,1,28275000,3,38333,1,18340417,01/05/2022,16.4,59871,31271,28600,19112,9469,9643
520,2,47530000,2,68219,2,30826281,01/05/2022,18.4,47632,25410,22222,12563,6265,6298
521,1,19512000,3,35135,1,12647665,01/05/2022,19.6,45587,23716,21871,14000,6913,7087
522,1,14113000,3,25726,1,9147724,01/05/2022,15.5,37704,19683,18021,12453,6131,6322
523,1,14294000,3,18640,1,9272460,01/05/2022,17,70224,35655,34569,24421,12033,12388
524,1,3255000,3,22816,1,2092934,01/05/2022,17,17978,9382,8596,6248,3105,3143
525,1,1558000,3,23937,1,988763,01/05/2022,17,13401,6929,6472,4288,2149,2139
526,1,1295000,3,15891,1,825859,01/05/2022,17,30417,15670,14747,9405,4719,4686
527,1,7947000,3,27137,1,5138413,01/05/2022,17,28657,14853,13804,9078,4552,4526
528,1,1227000,3,11206,1,786344,01/05/2022,17,1583,826,757,480,230,250
529,2,60172000,2,83791,2,39028009,01/05/2022,26.1,139075,74465,64610,36819,18286,18533
530,2,65858000,2,81408,2,42726292,01/05/2022,23.8,120500,65043,55457,29046,14403,14643
531,2,68884000,2,56896,2,44717704,01/05/2022,27.8,101336,54039,47297,24763,12096,12667
532,3,156033000,1,302482,3,101118968,01/05/2022,29.3,405952,215818,190134,89205,43880,45325
533,2,61186000,2,103980,2,39666920,01/05/2022,29.1,212540,111746,100794,51580,25268,26312
534,2,67123000,1,130142,2,43499808,01/05/2022,30.8,180057,96347,83710,45301,22589,22712
535,2,79680000,1,196742,2,51595258,01/05/2022,23.8,443063,237967,205096,110147,54509,55638
536,1,27182000,3,28842,1,17639458,01/05/2022,30.5,33226,17650,15576,10241,5095,5146
537,1,9933000,3,25584,1,6430866,01/05/2022,30.7,15512,8193,7319,4859,2440,2419
538,2,41495000,3,50922,2,26920828,01/05/2022,27.3,64445,34215,30230,17692,8626,9066
539,2,38173000,3,47303,2,24765147,01/05/2022,30.5,48567,25769,22798,13570,6693,6877
540,1,22996000,3,27259,1,14920141,01/05/2022,16.5,42451,22342,20109,14824,7241,7583
541,1,20435000,3,28429,1,13254321,01/05/2022,30.6,41588,21739,19849,12522,6161,6361
543,1,25496000,3,46603,1,16525797,01/05/2022,30.8,55452,29697,25755,14940,7380,7560
544,1,1736000,3,22304,1,1106096,01/05/2022,29.3,6076,3180,2896,1703,844,859
545,2,45074000,2,59441,2,29238659,01/05/2022,30.8,64692,34002,30690,19678,9778,9900
546,1,4590000,3,20968,1,2962532,01/05/2022,29.3,22760,12125,10635,6420,3229,3191
547,1,16497000,3,35359,1,10687691,01/05/2022,29.4,25608,13480,12128,7723,3870,3853
548,1,11810000,2,53405,1,7623095,01/05/2022,27.3,15733,8506,7227,4079,2054,2025
549,1,8535000,3,24408,1,5523342,01/05/2022,23.8,41785,22480,19305,10854,5445,5409
550,1,10599000,3,35760,1,6853590,01/05/2022,29.1,13225,6946,6279,3476,1669,1807
551,1,15497000,3,34337,1,10038713,01/05/2022,21.9,28655,15243,13412,8764,4302,4462
552,1,6212000,3,35505,1,4002295,01/05/2022,29.7,17727,9423,8304,4199,2068,2131
553,1,13913000,2,92825,1,8950625,01/05/2022,30.7,8969,4883,4086,2821,1444,1377
554,1,12134000,3,24183,1,7862917,01/05/2022,31.1,16758,8967,7791,4993,2542,2451
555,2,36464000,3,46809,2,23654791,01/05/2022,29.1,47035,25085,21950,12872,6289,6583
556,1,19523000,3,27380,1,12662570,01/05/2022,28.3,55720,29557,26163,14521,7123,7398
557,1,22498000,3,31605,1,14592095,01/05/2022,28.9,46909,24866,22043,15156,7483,7673
558,1,14191000,3,31149,1,9193001,01/05/2022,28.9,33986,17827,16159,9043,4421,4622
559,1,15689000,3,24390,1,10173460,01/05/2022,23.8,34847,18666,16181,8943,4380,4563
560,1,15403000,3,36407,1,9975543,01/05/2022,29.9,14304,7545,6759,4455,2182,2273
561,1,8832000,3,23416,1,5717384,01/05/2022,28.7,20797,10995,9802,4991,2418,2573
562,1,18599000,3,22581,1,12066769,01/05/2022,29.3,30232,15727,14505,8913,4281,4632
563,1,28147000,2,62014,1,18233536,01/05/2022,29.4,20165,10621,9544,5395,2701,2694
564,1,3017000,3,20026,1,1941024,01/05/2022,30.8,20380,10692,9688,6259,3127,3132
565,1,12458000,3,23158,1,8074542,01/05/2022,20,21640,11976,9664,7433,3885,3548
566,1,22002000,3,32932,1,14268368,01/05/2022,19.9,33402,17876,15526,9753,4761,4992
567,1,24509000,3,44513,1,15886337,01/05/2022,29.5,26236,13620,12616,8067,3962,4105
568,1,3669000,3,23816,1,2361034,01/05/2022,30.5,4405,2358,2047,1451,735,716
569,1,4037000,3,26895,1,2597155,01/05/2022,29.7,13716,7109,6607,3981,1920,2061
570,1,12333000,3,25383,1,7991067,01/05/2022,29.9,5653,2987,2666,1709,826,883
571,1,10436000,3,28708,1,6754692,01/05/2022,29.8,21318,11472,9846,5688,2873,2815
572,1,12160000,3,24667,1,7879333,01/05/2022,29.9,14582,7621,6961,4539,2262,2277
573,1,1813000,3,30274,1,1148176,01/05/2022,30.5,6219,3311,2908,1883,941,942
574,1,10146000,3,34364,1,6560536,01/05/2022,29.6,31856,17018,14838,8563,4318,4245
575,1,17438000,3,24985,1,11309715,01/05/2022,23.8,35893,18883,17010,11399,5600,5799
576,1,18279000,3,25789,1,11855561,01/05/2022,29.8,19272,10328,8944,5163,2534,2629
577,1,15935000,3,28099,1,10329651,01/05/2022,16.6,16364,8711,7653,5250,2654,2596
578,1,12463000,3,25261,1,8075689,01/05/2022,29.3,2820,1449,1371,720,341,379
579,1,2226000,3,24464,1,1422436,01/05/2022,31.3,4654,2510,2144,1296,630,666
580,1,1441000,3,23505,1,913145,01/05/2022,16.6,21585,11243,10342,6456,3197,3259
581,1,1671000,3,26551,1,1059599,01/05/2022,29.9,6888,3543,3345,1840,922,918
582,1,2013000,3,24747,1,1283703,01/05/2022,30,21391,11404,9987,5619,2742,2877
583,1,1629000,3,23678,1,1035172,01/05/2022,29.3,9668,5030,4638,2384,1141,1243
584,1,18158000,3,24752,1,11777948,01/05/2022,29.6,13995,7311,6684,4212,2070,2142
585,1,4859000,3,24151,1,3134199,01/05/2022,28.3,6838,3583,3255,1791,891,900
586,1,1656000,3,23678,1,1052722,01/05/2022,30,5681,3058,2623,1606,823,783
587,1,9918000,3,24881,1,6421819,01/05/2022,16.6,13966,7679,6287,3739,1859,1880
588,1,13797000,3,17705,1,8950345,01/05/2022,29.5,28076,14773,13303,7550,3752,3798
589,1,6467000,3,24519,1,4179031,01/05/2022,15.6,34039,18008,16031,8858,4334,4524
590,1,1994000,3,20428,1,1275672,01/05/2022,23.8,15807,8231,7576,5949,2955,2994
591,1,1195000,3,14421,1,762329,01/05/2022,28.3,10581,5508,5073,2907,1418,1489
592,1,4012000,3,22555,1,2585245,01/05/2022,21.5,9554,4935,4619,2707,1302,1405
593,1,14089000,3,49111,1,9108739,01/05/2022,28.9,9988,5342,4646,2237,1127,1110
594,1,2420000,3,14344,1,1558656,01/05/2022,30.8,7578,3984,3594,2088,1031,1057
595,1,2586000,3,23696,1,1657204,01/05/2022,22.5,8005,4106,3899,2599,1296,1303
596,1,2890000,3,22097,1,1856403,01/05/2022,29.5,24085,12288,11797,7909,3780,4129
597,1,4312000,3,22813,1,2779987,01/05/2022,30,7455,4054,3401,2223,1145,1078
598,1,1037000,3,8484,1,665566,01/05/2022,30.5,17919,9538,8381,4548,2298,2250
599,1,5708000,3,24262,1,3685938,01/05/2022,30.8,15305,8066,7239,4706,2332,2374
600,3,149803000,1,250287,3,97121663,01/05/2022,30.8,921771,479309,442462,222551,109790,112761
601,1,14073000,3,23264,1,9124186,01/05/2022,27.5,26081,13338,12743,7626,3791,3835
602,2,30209000,3,23949,2,19611901,01/05/2022,29.9,56494,29131,27363,17460,8617,8843
603,1,17637000,3,26763,1,11437287,01/05/2022,28.2,52593,26982,25611,16883,8307,8576
604,1,6206000,3,31393,1,4002507,01/05/2022,28.2,41965,21110,20855,11192,5453,5739
605,1,9092000,3,30323,1,5879477,01/05/2022,29.8,26175,13553,12622,8885,4301,4584
606,1,12069000,3,25855,1,7818995,01/05/2022,29.5,35183,17868,17315,10650,5230,5420
607,1,10279000,3,24752,1,6656598,01/05/2022,27.9,56409,28489,27920,16919,8292,8627
608,1,9158000,3,12305,1,5940395,01/05/2022,28.9,139753,70456,69297,45077,22298,22779
609,1,7568000,3,22952,1,4896248,01/05/2022,29.3,17841,9042,8799,5372,2677,2695
610,1,7902000,3,19059,1,5117241,01/05/2022,28.9,28461,14574,13887,9148,4533,4615
611,2,41689000,2,62390,2,27035460,01/05/2022,23.3,143281,73905,69376,47529,23519,24010
612,2,44572000,2,101762,2,28870038,01/05/2022,19.4,138444,72335,66109,38201,18773,19428
613,1,14817000,3,24278,1,9606772,01/05/2022,23.1,22295,11690,10605,8176,4115,4061
614,1,15432000,3,48436,1,9982364,01/05/2022,21.9,25068,12776,12292,8673,4237,4436
615,1,3288000,3,25771,1,2111429,01/05/2022,22.9,15291,7886,7405,5051,2477,2574
616,1,5723000,3,23538,1,3696412,01/05/2022,22.5,38193,19467,18726,13775,6896,6879
617,1,10934000,3,26253,1,7080847,01/05/2022,23.1,46132,23831,22301,13972,6871,7101
618,1,2238000,3,21495,1,1433205,01/05/2022,26.8,13641,7027,6614,4307,2133,2174
1,2,94011000,1,170380,2,60936770,01/04/2022,22.4,863893,444725,419168,260350,128225,132125
2,1,15549000,3,27045,1,10079805,01/04/2022,21.9,31963,16433,15530,11390,5609,5781
3,1,9546000,3,24043,1,6180857,01/04/2022,21.3,63805,32406,31399,23397,11652,11745
4,1,8598000,3,23027,1,5565673,01/04/2022,21.9,21049,10874,10175,7097,3529,3568
5,1,4760000,3,25334,1,3068666,01/04/2022,20.5,32035,16367,15668,10989,5374,5615
6,3,193610000,1,253679,3,125592821,01/04/2022,25.4,854186,425977,428209,227917,112151,115766
7,3,366882000,1,520059,3,237953241,01/04/2022,17.4,1810645,899293,911352,503963,246971,256992
8,2,77567000,2,88508,2,50330042,01/04/2022,15.3,330652,167339,163313,86895,42903,43992
9,2,30977000,3,26721,2,20108329,01/04/2022,17,81059,40420,40639,23492,11470,12022
10,2,30415000,2,52063,2,19717687,01/04/2022,16.5,100660,49935,50725,28067,13772,14295
11,1,18829000,3,22015,1,12216835,01/04/2022,22.8,19081,9476,9605,5934,2909,3025
12,2,72140000,1,109912,2,46781088,01/04/2022,24.9,250141,126245,123896,65670,32312,33358
13,2,52732000,2,65002,2,34210798,01/04/2022,19.4,136285,66083,70202,42780,21001,21779
14,2,66644000,2,99170,2,43219430,01/04/2022,23.3,202694,98608,104086,64935,31858,33077
15,1,21960000,3,31500,1,14242500,01/04/2022,21.2,43805,22160,21645,13050,6507,6543
16,1,23847000,2,70666,1,15429884,01/04/2022,23.5,16311,8010,8301,4984,2435,2549
17,1,10417000,3,25243,1,6745807,01/04/2022,22.3,14357,6822,7535,3854,1925,1929
18,1,2878000,3,25723,1,1844977,01/04/2022,16.1,13596,6842,6754,4196,2086,2110
19,1,8621000,3,24387,1,5579263,01/04/2022,20,13596,6842,6754,4196,2086,2110
20,1,3109000,3,25331,1,1995519,01/04/2022,19.3,7185,3509,3676,2099,1015,1084
21,2,40469000,2,66096,2,26238754,01/04/2022,29.2,191238,97313,93925,52600,25862,26738
22,2,39631000,2,64791,2,25695359,01/04/2022,30,249623,130524,119099,66498,32635,33863
23,1,25184000,3,26794,1,16342806,01/04/2022,29.2,31375,16375,15000,10682,5317,5365
24,1,16629000,3,27917,1,10780933,01/04/2022,29.2,35799,18291,17508,11962,5883,6079
25,1,11457000,3,27971,1,7419079,01/04/2022,29.7,15949,8217,7732,4538,2234,2304
26,2,75544000,2,82493,2,49021107,01/04/2022,29.9,217550,113613,103937,65123,32048,33075
27,2,42583000,3,44808,2,27634142,01/04/2022,17.9,183509,96930,86579,60413,30246,30167
28,2,44625000,2,68687,2,28937563,01/04/2022,22,113479,60064,53415,36594,18199,18395
29,2,97535000,2,97049,2,63300701,01/04/2022,28.9,578830,303756,275074,166456,82025,84431
30,2,35669000,3,32224,2,23152626,01/04/2022,29.4,51797,27093,24704,17614,8812,8802
31,2,55888000,1,118080,2,36209120,01/04/2022,27.4,38087,20017,18070,11916,5833,6083
32,1,11267000,3,22747,1,7300803,01/04/2022,30.9,32109,16780,15329,10495,5074,5421
33,1,25530000,3,22159,1,16572341,01/04/2022,26,21727,11415,10312,7786,3890,3896
34,1,16625000,3,27522,1,10778728,01/04/2022,27.7,49201,25651,23550,16539,8102,8437
35,1,20718000,3,39611,1,13427089,01/04/2022,27.2,37546,19668,17878,11791,5836,5955
36,1,21970000,2,74940,1,14205560,01/04/2022,20.4,47688,25247,22441,17870,8920,8950
37,1,4908000,3,23737,1,3166463,01/04/2022,28.7,55931,28786,27145,18430,9082,9348
38,1,10776000,3,26068,1,6978332,01/04/2022,26.2,29018,15064,13954,10291,5191,5100
39,1,9613000,3,25982,1,6222468,01/04/2022,28.2,18219,9592,8627,5806,2838,2968
40,1,13425000,3,26714,1,8699536,01/04/2022,28.4,15244,8058,7186,4848,2429,2419
41,1,4917000,3,22201,1,3173849,01/04/2022,30.9,25366,13345,12021,7752,3823,3929
42,1,16369000,3,24672,1,10615178,01/04/2022,29.3,19271,9996,9275,6517,3095,3422
43,1,4041000,3,20608,1,2606042,01/04/2022,29.3,7662,4073,3589,2321,1153,1168
45,3,279576000,1,251331,3,181473069,01/04/2022,19.9,1501551,750157,751394,459910,225614,234296
46,3,107994000,1,168960,3,70027140,01/04/2022,23.1,925762,474776,450986,250961,123448,127513
47,2,31457000,3,51495,2,20395555,01/04/2022,24.9,128548,65838,62710,37721,18411,19310
48,1,24651000,3,29429,1,15993721,01/04/2022,18.8,135586,69677,65909,41627,20458,21169
49,2,33491000,2,56399,2,21712751,01/04/2022,23.2,113843,59214,54629,34117,16974,17143
50,1,5084000,3,22311,1,3282289,01/04/2022,26.5,23140,11693,11447,7155,3499,3656
51,1,9808000,3,23757,1,6351443,01/04/2022,21,35087,17902,17185,11563,5663,5900
52,1,13069000,3,33491,1,8461359,01/04/2022,24.3,42019,21548,20471,12599,6234,6365
53,1,10668000,3,30032,1,6904168,01/04/2022,25.1,22066,11231,10835,6719,3420,3299
54,1,8994000,3,21602,1,5824498,01/04/2022,12,17410,9121,8289,6393,3204,3189
55,1,1981000,3,23265,1,1264385,01/04/2022,29.4,22568,11549,11019,7200,3540,3660
56,1,6045000,3,22771,1,3906479,01/04/2022,16.5,15054,7516,7538,5557,2768,2789
57,1,3430000,2,71227,1,2158273,01/04/2022,20.1,8253,4210,4043,2801,1419,1382
58,1,4514000,3,36222,1,2897878,01/04/2022,16.3,7834,4065,3769,2439,1200,1239
59,1,1710000,3,22273,1,1089227,01/04/2022,11.2,14755,7617,7138,4907,2427,2480
60,1,11608000,3,31384,1,7513816,01/04/2022,19.3,62038,31762,30276,19262,9511,9751
61,2,99540000,1,122433,2,64578567,01/04/2022,28.2,690193,353744,336449,203574,99881,103693
62,3,127463000,1,183683,3,82667267,01/04/2022,21.4,864431,434753,429678,267728,131619,136109
63,2,41656000,2,53926,2,27022474,01/04/2022,27.5,237169,119538,117631,71348,35023,36325
64,2,48020000,2,73129,2,31139871,01/04/2022,24.1,173959,86825,87134,55826,27459,28367
65,1,10336000,3,24091,1,6694309,01/04/2022,25.8,39058,19755,19303,11201,5479,5722
66,3,112036000,1,180563,3,72642837,01/04/2022,26.1,59762,30506,29256,20025,9931,10094
67,1,14950000,3,37121,1,9680379,01/04/2022,27.5,49490,25496,23994,16916,8460,8456
68,1,28215000,2,52318,1,18287432,01/04/2022,24.8,160225,79799,80426,53549,26489,27060
69,1,16187000,3,16402,1,10505148,01/04/2022,21.2,114010,56192,57818,38156,18905,19251
70,1,26350000,3,41682,1,17085818,01/04/2022,24.8,75242,37695,37547,23792,11778,12014
71,1,12216000,3,25372,1,7915028,01/04/2022,25.7,59196,29915,29281,18125,8949,9176
72,1,16182000,3,27550,1,10490750,01/04/2022,26.9,32704,16713,15991,11320,5572,5748
73,1,6980000,3,25405,1,4511595,01/04/2022,25.8,23413,11884,11529,7157,3552,3605
74,1,9139000,3,24102,1,5916248,01/04/2022,25.2,38992,19602,19390,13022,6299,6723
75,1,1554000,3,19493,1,990607,01/04/2022,27.4,27314,13703,13611,9005,4397,4608
76,2,52882000,2,63895,2,34309405,01/04/2022,26.6,146965,75962,71003,46271,22786,23485
77,1,27070000,3,28761,1,17566739,01/04/2022,27.6,88337,44762,43575,34686,17254,17432
78,2,39817000,2,61050,2,25820000,01/04/2022,25,159853,80569,79284,57402,28064,29338
79,1,2530000,3,22125,1,1622375,01/04/2022,26.9,9746,4912,4834,3336,1602,1734
80,1,1766000,3,24173,1,1123727,01/04/2022,25.8,15368,7632,7736,5699,2779,2920
81,1,1193000,3,9001,1,766449,01/04/2022,24.8,147496,76348,71148,49524,24280,25244
82,1,1036000,3,24095,1,649305,01/04/2022,25.4,14892,7420,7472,5365,2615,2750
83,1,7563000,3,25459,1,4890491,01/04/2022,25.8,34798,17459,17339,10865,5211,5654
84,2,37944000,1,186514,2,24477086,01/04/2022,21.2,432205,227255,204950,86717,42372,44345
85,2,40685000,1,171551,2,26273699,01/04/2022,20.7,759003,398068,360935,168014,83097,84917
86,2,93117000,1,319279,2,60206771,01/04/2022,21.1,1173351,609477,563874,261635,129105,132530
87,1,25817000,2,62381,1,16718669,01/04/2022,21.7,414470,219003,195467,75588,37198,38390
88,1,16892000,2,55505,1,10924295,01/04/2022,18.7,186693,97615,89078,46165,22603,23562
89,3,153585000,1,355818,3,99474432,01/04/2022,21.7,1835486,947835,887651,451632,222341,229291
90,2,52157000,1,117713,2,33784337,01/04/2022,20.3,614447,325337,289110,113945,55951,57994
91,1,24939000,2,82793,1,16127557,01/04/2022,20.6,434153,232032,202121,62030,30612,31418
92,2,52999000,1,121594,2,34327756,01/04/2022,20.3,323771,167274,156497,83659,40990,42669
93,2,43213000,2,79255,2,28009195,01/04/2022,19.2,404695,212343,192352,85496,42058,43438
94,1,24959000,1,149703,1,16073647,01/04/2022,20.3,443704,233586,210118,95713,47173,48540
95,2,61552000,1,273152,2,39735648,01/04/2022,21.1,545884,284933,260951,101794,50260,51534
96,1,15445000,2,57659,1,9981591,01/04/2022,18.9,429481,220393,209088,105785,52018,53767
97,1,9459000,3,47466,1,6100884,01/04/2022,15,246428,128767,117661,58169,28791,29378
98,1,11962000,3,29549,1,7745751,01/04/2022,15,599935,314284,285651,130174,64060,66114
99,3,114436000,1,164479,3,74218921,01/04/2022,22.1,616068,317266,298802,191866,94056,97810
100,2,70638000,2,83087,2,45831613,01/04/2022,20.9,301742,154079,147663,97495,48007,49488
101,1,10088000,3,21358,1,6535842,01/04/2022,25.4,96243,49040,47203,29383,14345,15038
102,1,15688000,3,30967,1,10166233,01/04/2022,20.5,30063,15334,14729,10450,5151,5299
103,1,1560000,2,92166,1,921834,01/04/2022,25.4,3222,1654,1568,1247,637,610
104,1,11193000,2,72078,1,7203372,01/04/2022,19.5,17967,9205,8762,6003,2945,3058
105,1,2208000,3,21793,1,1413407,01/04/2022,19.8,11943,6311,5632,3854,1993,1861
106,1,1634000,2,90929,1,971171,01/04/2022,23.8,12850,6538,6312,4678,2267,2411
107,2,34650000,2,100881,2,22421619,01/04/2022,12.8,26678,13733,12945,10032,4897,5135
108,3,155749000,1,228977,3,101007873,01/04/2022,16.5,223876,119352,104524,50306,24928,25378
109,2,59175000,1,180786,2,38282964,01/04/2022,17.7,515353,266081,249272,126007,61695,64312
110,2,93681000,1,321048,2,60571602,01/04/2022,18.3,776220,402522,373698,193769,95439,98330
111,2,56676000,1,105144,2,36734256,01/04/2022,18.3,84298,43745,40553,23019,11356,11663
112,2,43646000,2,59421,2,28310479,01/04/2022,17.5,30929,15848,15081,8319,4034,4285
113,1,28881000,2,103817,1,18668833,01/04/2022,18.3,293245,152241,141004,70657,34731,35926
114,2,55151000,1,220882,2,35627268,01/04/2022,17.7,658907,338453,320454,150053,73914,76139
115,1,23248000,3,22694,1,15088506,01/04/2022,17.7,117995,60165,57830,29983,14851,15132
116,3,154974000,1,292800,3,100440300,01/04/2022,15.4,1643623,845932,797691,437489,216020,221469
117,2,67595000,1,148586,2,43788164,01/04/2022,22.1,368585,190133,178452,107535,52900,54635
118,2,41775000,2,62977,2,27090773,01/04/2022,9.8,174704,91497,83207,54449,28355,26094
119,1,18367000,3,45337,1,11893213,01/04/2022,7.4,2931,1520,1411,975,512,463
120,2,49577000,1,107272,2,32117778,01/04/2022,11.5,35491,18986,16505,7987,3993,3994
121,2,59896000,1,146798,2,38785602,01/04/2022,18.3,703215,359601,343614,230612,113552,117060
122,2,57110000,1,176957,2,36944543,01/04/2022,20.3,18226,9300,8926,5308,2603,2705
123,2,47690000,2,54608,2,30943892,01/04/2022,18.8,1072676,556998,515678,265425,131078,134347
124,1,20501000,3,18909,1,13306741,01/04/2022,23.8,14038,7254,6784,3763,1910,1853
125,2,62856000,2,77300,2,40779100,01/04/2022,9.8,174704,91497,83207,54449,28355,26094
126,2,48691000,3,32926,2,31616224,01/04/2022,15.9,7077,3593,3484,1748,893,855
127,2,32771000,2,52899,2,21248251,01/04/2022,17,53362,27304,26058,15169,7515,7654
128,1,15362000,3,18393,1,9966907,01/04/2022,6.2,24612,12254,12358,7339,3541,3798
129,2,44456000,1,164513,2,28731887,01/04/2022,19.4,10873,5623,5250,3757,1878,1879
130,2,52319000,2,56915,2,33950435,01/04/2022,15.3,23219,12339,10880,6425,3186,3239
131,1,23803000,3,37677,1,15434273,01/04/2022,18.3,12671,6512,6159,3454,1710,1744
132,1,20234000,3,31617,1,13120483,01/04/2022,13.9,30967,16277,14690,10756,5327,5429
133,2,38363000,2,56371,2,24879579,01/04/2022,20,323545,166328,157217,93932,46757,47175
134,1,5955000,3,18463,1,3852287,01/04/2022,24.8,19326,10155,9171,6252,3129,3123
135,1,19899000,3,33828,1,12900522,01/04/2022,9.8,33716,17686,16030,9317,4624,4693
136,1,12018000,3,50457,1,7761243,01/04/2022,17.1,40279,20716,19563,10282,5078,5204
137,1,3510000,3,21431,1,2260069,01/04/2022,18.2,29068,14916,14152,8580,4220,4360
138,1,25532000,2,55548,1,16540252,01/04/2022,19.5,12752,6694,6058,3471,1768,1703
139,1,4286000,3,47785,1,2738115,01/04/2022,16.6,33166,16973,16193,9497,4707,4790
140,1,5747000,3,11777,1,3723773,01/04/2022,17.7,52828,27143,25685,16500,8128,8372
141,1,27291000,3,24337,1,17714813,01/04/2022,17.2,32738,16941,15797,9059,4431,4628
142,1,9561000,3,24887,1,6189763,01/04/2022,18.2,30203,15792,14411,7568,3777,3791
143,1,28630000,3,37563,1,18571937,01/04/2022,17.7,11760,6069,5691,3432,1700,1732
144,1,11059000,3,20138,1,7168212,01/04/2022,18.8,72525,37076,35449,22128,10944,11184
145,1,7215000,3,25698,1,4664052,01/04/2022,7.4,18580,9729,8851,5724,2801,2923
146,1,18389000,3,28265,1,11924585,01/04/2022,20.3,24575,12798,11777,7126,3453,3673
147,1,1206000,3,20735,1,763165,01/04/2022,18.3,44731,22925,21806,13335,6514,6821
148,1,7786000,2,52542,1,5008358,01/04/2022,16.8,658907,338453,320454,150053,73914,76139
149,1,12561000,3,27059,1,8137591,01/04/2022,18.3,10336,5387,4949,3449,1664,1785
150,1,10043000,3,21534,1,6506416,01/04/2022,15.8,4656,2421,2235,1533,751,782
151,1,5801000,3,26370,1,3744280,01/04/2022,20,9598,5002,4596,2910,1467,1443
152,1,9618000,3,18082,1,6233618,01/04/2022,17.7,15171,7853,7318,4470,2251,2219
153,1,5667000,3,23877,1,3659673,01/04/2022,18.2,10792,5577,5215,3492,1713,1779
154,1,1869000,3,4526,1,1210324,01/04/2022,17.7,37442,19141,18301,12089,5963,6126
155,1,3290000,3,25494,1,2113006,01/04/2022,9.8,17736,9182,8554,5577,2775,2802
156,1,8683000,3,10150,1,5633800,01/04/2022,20.3,386290,199249,187041,112223,55337,56886
157,1,7936000,3,28596,1,5129804,01/04/2022,20.3,9925,5218,4707,2833,1403,1430
158,1,7181000,3,24328,1,4643322,01/04/2022,23.8,6944,3666,3278,2341,1149,1192
159,1,6447000,3,24118,1,4166432,01/04/2022,15.4,88734,45471,43263,28316,14166,14150
160,1,7106000,3,19067,1,4599833,01/04/2022,11.5,6449,3346,3103,1687,833,854
161,1,5923000,3,17467,1,3832483,01/04/2022,15.6,10735,5576,5159,3010,1518,1492
162,1,2677000,3,20115,1,1719935,01/04/2022,11.5,10810,5614,5196,2941,1451,1490
163,1,1227000,3,956,1,796594,01/04/2022,27.1,13038,6614,6424,4157,2015,2142
165,3,161767000,1,232877,3,104915673,01/04/2022,24.1,1579803,804212,775591,594938,292494,302444
166,2,68420000,2,66989,2,44406011,01/04/2022,19.5,378143,194849,183294,128863,62806,66057
167,2,66712000,2,52514,2,43310286,01/04/2022,21.9,452090,230346,221744,162764,80177,82587
168,1,21137000,3,35785,1,13703265,01/04/2022,22.8,69371,35473,33898,25304,12303,13001
169,1,27665000,3,33222,1,17949028,01/04/2022,22.1,79772,40908,38864,30907,15312,15595
170,1,21416000,3,37605,1,13882795,01/04/2022,22.5,56597,29703,26894,19146,9514,9632
171,1,21450000,3,31474,1,13911026,01/04/2022,19.8,72663,38036,34627,27395,13712,13683
172,2,41453000,2,78532,2,26865918,01/04/2022,22.5,160682,83178,77504,52342,25860,26482
173,1,26923000,3,35792,1,17464158,01/04/2022,20.6,83352,42766,40586,32937,16375,16562
174,1,28260000,3,33473,1,18335527,01/04/2022,20.2,67101,35567,31534,27008,13393,13615
175,1,14811000,3,33823,1,9593327,01/04/2022,22.4,43249,22352,20897,17065,8284,8781
176,1,22063000,3,38493,1,14302457,01/04/2022,20.1,51894,27702,24192,20579,10113,10466
177,1,21557000,3,47826,1,13964224,01/04/2022,22.3,70068,36526,33542,21044,10402,10642
178,1,18403000,3,25912,1,11936038,01/04/2022,20.9,52156,27081,25075,17108,8394,8714
179,1,3358000,3,25120,1,2157580,01/04/2022,22.8,41910,21741,20169,12631,6146,6485
180,1,20156000,3,48634,1,13052766,01/04/2022,20.8,43998,23109,20889,17575,8775,8800
181,1,4625000,3,25379,1,2980871,01/04/2022,24.5,24757,12827,11930,9816,4898,4918
182,1,3573000,3,19158,1,2303292,01/04/2022,21,21756,11234,10522,8659,4317,4342
183,1,7000000,3,9921,1,4540079,01/04/2022,20.8,28109,14419,13690,10548,5187,5361
184,1,5187000,3,23225,1,3348325,01/04/2022,22.2,15305,7996,7309,5899,2872,3027
185,1,23216000,3,37519,1,15052881,01/04/2022,21.5,72452,38019,34433,23628,11618,12010
186,1,17093000,3,24281,1,11086169,01/04/2022,21.3,35401,18444,16957,12235,5945,6290
187,1,22540000,3,36955,1,14614045,01/04/2022,21.6,27593,14289,13304,10803,5260,5543
188,1,16496000,3,23609,1,10698791,01/04/2022,22.2,31264,16171,15093,9806,4840,4966
189,1,16844000,3,36086,1,10912514,01/04/2022,18.2,24228,12861,11367,9383,4674,4709
190,1,16413000,3,25561,1,10642889,01/04/2022,18.5,32831,17049,15782,13856,6706,7150
191,1,2283000,3,23042,1,1460908,01/04/2022,22.8,16092,8507,7585,6837,3451,3386
192,1,7037000,3,27920,1,4546130,01/04/2022,21,8011,4268,3743,3134,1562,1572
193,1,13317000,3,24526,1,8631524,01/04/2022,24.5,29002,14796,14206,11206,5550,5656
194,1,2615000,3,26714,1,1673036,01/04/2022,20,7946,4172,3774,3293,1607,1686
195,1,9823000,3,9761,1,6375189,01/04/2022,23.4,28260,14728,13532,11002,5473,5529
196,1,5503000,3,5449,1,3571501,01/04/2022,21.2,25845,13471,12374,9370,4627,4743
197,3,131767000,1,175491,3,85473059,01/04/2022,26.9,658609,345979,312630,183298,90145,93153
198,2,53366000,2,57715,2,34630185,01/04/2022,23.7,225728,119129,106599,71494,35347,36147
199,2,31311000,3,41883,2,20310267,01/04/2022,29.8,70760,36613,34147,21788,10705,11083
200,2,39478000,2,77497,2,25583203,01/04/2022,29.5,132854,69610,63244,41183,20301,20882
201,1,16540000,2,55467,1,10695533,01/04/2022,24.1,50399,26542,23857,14000,6918,7082
202,1,2589000,3,26326,1,1656524,01/04/2022,26.2,27944,14419,13525,9490,4664,4826
203,1,5687000,3,26870,1,3669680,01/04/2022,19.2,22534,11802,10732,7926,3939,3987
204,1,12760000,3,28211,1,8265789,01/04/2022,26.8,25148,13436,11712,8928,4476,4452
205,1,22578000,3,27146,1,14648554,01/04/2022,23.1,33783,18241,15542,12201,6089,6112
206,2,31045000,3,28387,2,20150863,01/04/2022,32.2,25850,13268,12582,8390,4048,4342
208,2,33435000,3,35946,2,21696804,01/04/2022,20.5,27607,14605,13002,9883,5002,4881
209,1,9363000,3,26340,1,6059610,01/04/2022,25.9,13866,7187,6679,4383,2099,2284
210,1,6240000,3,25767,1,4030233,01/04/2022,27.3,23363,12127,11236,7776,3818,3958
211,1,14375000,3,31602,1,9312148,01/04/2022,27,18224,9500,8724,7072,3514,3558
212,1,12799000,3,24550,1,8294800,01/04/2022,27.3,16447,8464,7983,4843,2381,2462
213,1,5455000,3,13633,1,3532117,01/04/2022,26.5,17550,9283,8267,5700,2861,2839
214,2,61928000,1,154405,2,40098795,01/04/2022,19.3,297848,156299,141549,74787,37046,37741
215,1,26587000,3,20418,1,17261132,01/04/2022,20.5,29390,15521,13869,7939,3942,3997
216,2,29556000,2,67597,2,19143803,01/04/2022,21.6,37608,20094,17514,11115,5490,5625
217,2,34762000,2,68655,2,22526645,01/04/2022,20.6,106163,56161,50002,30752,15034,15718
218,1,12739000,3,24044,1,8256306,01/04/2022,17.7,11149,5894,5255,2996,1479,1517
219,2,33910000,3,51626,2,21989874,01/04/2022,16.3,60265,30945,29320,18808,9224,9584
220,1,18367000,3,31760,1,11906790,01/04/2022,21.7,17718,9411,8307,4913,2492,2421
221,1,15901000,3,31111,1,10304539,01/04/2022,20,36618,19077,17541,10530,5273,5257
222,1,9845000,3,23321,1,6375929,01/04/2022,24.7,9853,5224,4629,2757,1390,1367
223,1,2390000,3,26189,1,1527311,01/04/2022,20.5,27713,14561,13152,7736,3885,3851
224,1,6097000,3,23874,1,3939176,01/04/2022,18.2,32276,17014,15262,9457,4578,4879
225,1,7719000,3,23807,1,4993543,01/04/2022,24.7,14689,7582,7107,4123,2033,2090
226,2,40155000,3,47009,2,26053741,01/04/2022,26.7,44311,23331,20980,13756,6771,6985
227,1,3720000,3,25276,1,2392724,01/04/2022,23.3,14732,7791,6941,4911,2433,2478
228,1,10144000,3,25070,1,6568530,01/04/2022,19.6,20530,10890,9640,6356,3180,3176
229,1,11319000,3,22179,1,7335171,01/04/2022,27.1,16368,8558,7810,4728,2323,2405
230,1,7674000,3,23831,1,4964269,01/04/2022,16.1,6213,3216,2997,1786,871,915
231,1,9707000,3,21717,1,6287833,01/04/2022,16.3,28792,15288,13504,8327,4111,4216
233,1,4133000,3,6731,1,2679719,01/04/2022,24,8657,4501,4156,2464,1200,1264
234,2,61976000,1,107434,2,40176966,01/04/2022,22.8,224166,112147,112019,65088,31954,33134
235,1,24831000,3,51400,1,16088750,01/04/2022,20.6,111569,57370,54199,36412,17892,18520
236,1,23957000,3,32789,1,15539261,01/04/2022,22.4,38780,20122,18658,13025,6461,6564
237,3,139510000,1,334304,3,90347196,01/04/2022,22.7,1385621,718628,666993,333198,164217,168981
238,2,95672000,1,243985,2,61942815,01/04/2022,21.5,1257547,645398,612149,321993,158559,163434
239,1,18954000,3,18201,1,12301899,01/04/2022,22.3,37871,19554,18317,11359,5732,5627
240,2,76571000,1,194208,2,49576942,01/04/2022,25.1,650123,329365,320758,200033,98558,101475
241,2,35140000,2,68207,2,22772793,01/04/2022,21.9,111975,57735,54240,31481,15460,16021
242,1,12832000,3,23172,1,8317628,01/04/2022,22.4,98842,50427,48415,30938,15263,15675
243,2,57507000,1,181288,2,37198262,01/04/2022,20.9,44103,22420,21683,15768,7755,8013
244,1,9589000,3,27943,1,6204907,01/04/2022,19.8,53539,27205,26334,18000,8916,9084
245,1,10650000,3,26219,1,6896281,01/04/2022,25.5,18787,9476,9311,6502,3270,3232
246,1,14882000,3,33820,1,9639480,01/04/2022,22.4,59648,30609,29039,19344,9536,9808
247,2,54207000,2,102809,2,35131741,01/04/2022,21.9,30471,15635,14836,9610,4654,4956
248,1,3348000,3,25544,1,2150656,01/04/2022,23,20286,10307,9979,6804,3413,3391
249,1,3978000,3,22654,1,2563046,01/04/2022,24.5,20345,10131,10214,6733,3300,3433
250,1,17692000,3,38641,1,11461159,01/04/2022,23.1,31115,15891,15224,10525,5240,5285
251,1,11665000,3,45466,1,7536784,01/04/2022,23,16550,8456,8094,5252,2552,2700
252,1,14392000,3,24776,1,9330024,01/04/2022,23.9,24352,12627,11725,8092,4062,4030
253,1,19804000,3,37447,1,12835153,01/04/2022,20.6,94978,48709,46269,29794,14672,15122
254,1,23185000,3,28995,1,15041255,01/04/2022,24.5,52019,26739,25280,15725,7759,7966
255,1,3210000,3,23673,1,2062827,01/04/2022,22.7,24580,12765,11815,8215,4057,4158
256,1,11643000,3,23801,1,7544149,01/04/2022,22.5,28678,14679,13999,9074,4497,4577
257,1,3253000,3,23543,1,2090907,01/04/2022,17.8,22738,11719,11019,7000,3537,3463
258,1,9025000,3,24021,1,5842229,01/04/2022,21.9,28145,14670,13475,8863,4390,4473
259,1,7471000,3,28516,1,4827634,01/04/2022,21.9,19113,9852,9261,5504,2716,2788
260,1,1480000,3,23645,1,938355,01/04/2022,19.8,25925,13382,12543,8585,4189,4396
261,1,847000,3,23138,1,527412,01/04/2022,22.5,13033,6697,6336,4420,2181,2239
262,1,2263000,3,22989,1,1447961,01/04/2022,12.8,5955,3118,2837,1972,974,998
263,1,1413000,3,20391,1,898059,01/04/2022,23.1,8850,4524,4326,2773,1377,1396
264,1,1984000,3,21787,1,1267813,01/04/2022,17.8,9529,4943,4586,3018,1490,1528
265,1,9012000,3,26578,1,5831222,01/04/2022,19.8,14636,7533,7103,4910,2424,2486
266,1,15167000,3,34398,1,9824152,01/04/2022,23,40906,20800,20106,12864,6409,6455
267,1,6026000,3,25718,1,3891182,01/04/2022,21.9,8142,4289,3853,2686,1333,1353
268,1,1748000,3,22654,1,1113546,01/04/2022,17.8,7954,4060,3894,2570,1274,1296
269,1,10563000,3,25001,1,6840949,01/04/2022,23.1,17000,8527,8473,5215,2549,2666
270,1,3274000,3,22794,1,2105306,01/04/2022,19.7,14424,7439,6985,5399,2678,2721
271,1,2476000,3,23509,1,1585891,01/04/2022,23.1,16873,8725,8148,6022,3008,3014
272,1,2400000,3,18289,1,1541711,01/04/2022,21.9,5109,2618,2491,1631,805,826
273,1,2018000,3,23502,1,1288198,01/04/2022,21.9,13243,6795,6448,4043,1954,2089
274,1,2244000,3,21940,1,1436660,01/04/2022,19.8,14497,7627,6870,4260,2099,2161
275,1,1878000,3,19587,1,1201113,01/04/2022,24.1,16324,8373,7951,5562,2774,2788
276,1,4435000,3,25294,1,2857456,01/04/2022,25.5,9842,5047,4795,3323,1629,1694
277,1,2843000,3,22152,1,1825798,01/04/2022,19.8,27833,14525,13308,9097,4581,4516
278,1,4238000,3,5252,1,2749448,01/04/2022,24,33284,17172,16112,10804,5349,5455
279,1,1728000,3,22175,1,1101025,01/04/2022,24.3,14697,7601,7096,4740,2380,2360
280,1,3480000,3,19137,1,2242863,01/04/2022,20.6,18607,9363,9244,6403,3178,3225
284,2,97429000,1,162357,2,63166493,01/04/2022,26.1,743275,388114,355161,202467,99875,102592
285,2,37157000,2,77144,2,24074906,01/04/2022,19.8,154546,80401,74145,48513,24003,24510
286,2,63081000,2,86492,2,40916158,01/04/2022,20.4,299523,155411,144112,93845,46362,47483
287,2,44088000,2,63792,2,28593408,01/04/2022,25.6,83637,42325,41312,24783,12286,12497
288,2,38450000,2,67323,2,24925177,01/04/2022,29.9,102362,52461,49901,35162,17416,17746
289,1,15476000,3,34534,1,10024866,01/04/2022,22,55287,28877,26410,16959,8447,8512
290,1,19009000,3,38927,1,12316923,01/04/2022,24.8,87042,45232,41810,26414,12958,13456
291,2,33824000,2,56680,2,21928920,01/04/2022,12.5,86901,45620,41281,26262,13160,13102
292,1,21237000,3,22999,1,13781051,01/04/2022,22.4,30519,15931,14588,10809,5325,5484
293,2,29673000,3,35746,2,19251704,01/04/2022,19,60811,31893,28918,19713,9706,10007
294,1,2995000,3,9644,1,1937106,01/04/2022,18.2,61510,31765,29745,21000,10487,10513
295,1,19694000,3,49728,1,12751372,01/04/2022,18.7,70042,36241,33801,21818,10809,11009
296,1,4120000,3,9767,1,2668233,01/04/2022,18.3,24662,12965,11697,6937,3350,3587
297,1,5661000,3,20361,1,3659289,01/04/2022,18.2,15414,7999,7415,4635,2291,2344
298,1,21503000,3,24776,1,13952174,01/04/2022,18.7,71528,37497,34031,23278,11539,11739
299,1,2019000,3,24175,1,1288175,01/04/2022,22.4,15249,7932,7317,4894,2453,2441
300,1,26393000,3,26014,1,17129436,01/04/2022,19.5,39425,20578,18847,13203,6477,6726
301,1,3401000,3,25361,1,2185289,01/04/2022,18.3,17293,8766,8527,5650,2795,2855
302,1,11472000,3,25005,1,7431795,01/04/2022,12.5,16905,8772,8133,5514,2740,2774
303,1,3422000,3,23199,1,2201101,01/04/2022,19,18097,9360,8737,5881,2892,2989
304,1,12891000,3,24386,1,8354764,01/04/2022,23.2,32333,16690,15643,10314,5057,5257
305,1,17343000,3,26654,1,11246296,01/04/2022,21.7,49940,25545,24395,16071,7998,8073
306,1,16549000,3,26487,1,10730363,01/04/2022,19.2,1049,546,503,282,149,133
307,1,12827000,3,25005,1,8312545,01/04/2022,21.1,6853,3584,3269,2311,1149,1162
308,1,5972000,3,5049,1,3876751,01/04/2022,29.2,12262,6119,6143,4251,2104,2147
309,1,1931000,3,28828,1,1226322,01/04/2022,21.7,11086,5609,5477,3615,1780,1835
310,1,2435000,3,8873,1,1573877,01/04/2022,24.8,13821,7083,6738,3938,1966,1972
311,2,49350000,1,138110,2,31939390,01/04/2022,25.5,341029,180370,160659,82444,40670,41774
312,2,66832000,2,96359,2,43344441,01/04/2022,26.2,157336,82380,74956,43883,21497,22386
313,1,21631000,3,9353,1,14050797,01/04/2022,29.4,174629,91268,83361,46521,22880,23641
314,1,28133000,3,46353,1,18240097,01/04/2022,27.3,104461,54150,50311,30967,15315,15652
315,1,15627000,3,48337,1,10109213,01/04/2022,26.3,44353,23038,21315,13070,6400,6670
316,1,4209000,3,25644,1,2710206,01/04/2022,28.7,21375,11206,10169,5662,2753,2909
317,2,31203000,3,40139,2,20241811,01/04/2022,29.2,17777,9225,8552,4254,2086,2168
318,2,37632000,2,92141,2,24368659,01/04/2022,29.4,64084,32934,31150,19785,9668,10117
319,1,13856000,3,27168,1,8979232,01/04/2022,28.1,20434,10867,9567,5939,2970,2969
320,1,13435000,3,25358,1,8707392,01/04/2022,19.8,19085,9763,9322,6343,3119,3224
321,2,87644000,1,126427,2,56842173,01/04/2022,20.1,371387,192530,178857,106784,52432,54352
322,1,19639000,3,21992,1,12743358,01/04/2022,23.8,18023,9240,8783,5154,2503,2651
323,1,12426000,3,46055,1,8030845,01/04/2022,23.7,20322,10479,9843,6201,3025,3176
324,1,17734000,3,31693,1,11495407,01/04/2022,23.7,25477,13300,12177,8208,4059,4149
325,1,9058000,3,51101,1,5836599,01/04/2022,24.9,13620,7015,6605,4098,1994,2104
326,1,12095000,3,24534,1,7837216,01/04/2022,23.7,48170,25016,23154,15515,7657,7858
327,1,8658000,3,49999,1,5577701,01/04/2022,27.2,10593,5340,5253,3485,1705,1780
328,2,35713000,2,73879,2,23139571,01/04/2022,23.8,8730,4395,4335,2894,1447,1447
329,1,4142000,3,23874,1,2668426,01/04/2022,25.7,14678,7367,7311,4863,2405,2458
330,1,6958000,3,24243,1,4498457,01/04/2022,23.8,10935,5450,5485,3532,1706,1826
331,1,10377000,3,23608,1,6721442,01/04/2022,26.3,19976,10345,9631,6431,3120,3311
332,2,55979000,2,102498,2,36283852,01/04/2022,26.3,412199,209241,202958,82879,40585,42294
333,2,55413000,1,124001,2,35894449,01/04/2022,26.7,304052,152635,151417,84118,41457,42661
334,2,87102000,1,140044,2,56476256,01/04/2022,24.6,536436,267279,269157,158598,77797,80801
335,3,110439000,1,146137,3,71639213,01/04/2022,24.6,635862,320627,315235,153834,75737,78097
336,3,132041000,1,215842,3,85610808,01/04/2022,25,1142952,578172,564780,270109,132170,137939
338,1,14817000,3,47204,1,9583846,01/04/2022,24.6,75721,38037,37684,21903,10795,11108
339,1,18419000,3,35905,1,11936445,01/04/2022,28.7,70378,35870,34508,21367,10464,10903
340,2,42388000,3,25595,2,27526605,01/04/2022,18.3,308285,152976,155309,108145,53196,54949
342,2,37966000,2,63688,2,24614212,01/04/2022,22.1,234698,115478,119220,87040,43098,43942
343,1,12087000,3,27791,1,7828759,01/04/2022,24.6,28843,14318,14525,8529,4190,4339
344,1,11413000,3,25670,1,7392780,01/04/2022,25.8,33522,17126,16396,9330,4711,4619
345,1,15574000,3,48414,1,10074686,01/04/2022,26.3,54467,27606,26861,15858,7789,8069
346,1,15676000,3,20502,1,10168898,01/04/2022,26.3,13059,6525,6534,4137,2073,2064
347,1,1345000,3,4209,1,870041,01/04/2022,18.3,9934,4952,4982,3082,1558,1524
348,1,5181000,3,26094,1,3341556,01/04/2022,18.3,7844,4131,3713,2621,1355,1266
349,1,7410000,3,49343,1,4767157,01/04/2022,24.6,48069,23121,24948,16392,8040,8352
350,1,9530000,3,21356,1,6173144,01/04/2022,26.7,11583,5810,5773,3713,1872,1841
351,1,4243000,3,20723,1,2737227,01/04/2022,27.2,29903,15539,14364,9778,4798,4980
352,3,128805000,1,258825,3,83464425,01/04/2022,26.7,258913,138803,120110,68042,33683,34359
353,2,46685000,2,83225,2,30262025,01/04/2022,28.9,103609,54904,48705,31555,15575,15980
354,1,27182000,2,74243,1,17594057,01/04/2022,29.4,76660,40113,36547,21596,10646,10950
355,2,37175000,3,51261,2,24112489,01/04/2022,29.9,88280,46038,42242,25864,12608,13256
356,1,27393000,2,57960,1,17747490,01/04/2022,23.3,56163,29689,26474,18214,8872,9342
357,1,2219000,3,29857,1,1412493,01/04/2022,28.9,7263,3837,3426,2540,1279,1261
358,1,15027000,3,24744,1,9742806,01/04/2022,28.4,16645,8759,7886,5075,2484,2591
359,1,12781000,3,51193,1,8256457,01/04/2022,28.5,31469,16729,14740,9837,4899,4938
360,1,13624000,3,23830,1,8831770,01/04/2022,18.1,12729,6935,5794,4541,2296,2245
361,1,12694000,3,27259,1,8223841,01/04/2022,29.9,26015,13735,12280,7360,3633,3727
362,2,39934000,3,31281,2,25925819,01/04/2022,27.2,29903,15539,14364,9778,4798,4980
363,1,23931000,3,35942,1,15519208,01/04/2022,28.2,10504,5405,5099,3440,1722,1718
364,1,16885000,3,26241,1,10949009,01/04/2022,30.1,45134,23442,21692,13494,6690,6804
365,1,20440000,3,49194,1,13236806,01/04/2022,22,29130,15431,13699,9957,5019,4938
366,1,4632000,3,20354,1,2990446,01/04/2022,28.5,5812,3105,2707,1767,906,861
367,1,13289000,3,26003,1,8611847,01/04/2022,18.1,15851,8463,7388,5625,2839,2786
368,1,4768000,3,23774,1,3075426,01/04/2022,22,15298,8185,7113,4499,2268,2231
369,1,26667000,3,28299,1,17305251,01/04/2022,29.9,17525,9370,8155,5075,2488,2587
370,1,18687000,2,71847,1,12074703,01/04/2022,18.1,18915,10248,8667,6395,3217,3178
371,1,19962000,3,22613,1,12952687,01/04/2022,24.3,81848,43535,38313,23849,11894,11955
372,2,35911000,3,35367,2,23306783,01/04/2022,23.5,33726,17513,16213,11096,5372,5724
373,1,1973000,3,20698,1,1261752,01/04/2022,22,11168,5931,5237,3889,1954,1935
374,1,4798000,3,23738,1,3094962,01/04/2022,28.9,6341,3343,2998,2049,979,1070
375,1,20083000,3,13774,1,13040176,01/04/2022,24.3,45895,23816,22079,12162,5997,6165
376,1,5888000,3,39298,1,3787902,01/04/2022,28.8,6863,3664,3199,2612,1321,1291
377,1,9393000,3,25908,1,6079542,01/04/2022,23.5,10611,5602,5009,3876,1871,2005
378,1,3323000,3,25674,1,2134276,01/04/2022,28.4,14226,7514,6712,4380,2214,2166
379,1,4685000,3,20594,1,3024656,01/04/2022,24.3,7997,4114,3883,2359,1161,1198
380,1,3527000,3,9473,1,2283077,01/04/2022,28.5,4188,2243,1945,1509,761,748
381,1,26933000,2,57877,1,17448573,01/04/2022,27.2,15373,8115,7258,5203,2638,2565
382,1,15151000,3,23407,1,9824743,01/04/2022,28.5,14071,7408,6663,4497,2251,2246
383,1,2076000,3,20585,1,1328815,01/04/2022,17.8,6642,3720,2922,2058,1005,1053
384,1,7245000,3,6573,1,4702677,01/04/2022,28.3,11054,5638,5416,3563,1745,1818
385,3,197476000,1,406580,3,127952820,01/04/2022,21,1542232,806262,735970,402209,198130,204079
386,2,43056000,2,63095,2,27923305,01/04/2022,17.9,78264,40929,37335,23163,11368,11795
387,2,58117000,2,76185,2,37699865,01/04/2022,23,293825,155300,138525,93203,46206,46997
388,1,26562000,3,42795,1,17222505,01/04/2022,27.3,49578,26095,23483,16381,8171,8210
389,2,32593000,3,35452,2,21149998,01/04/2022,21.5,89314,47398,41916,25892,12760,13132
390,2,38663000,3,33286,2,25097664,01/04/2022,20,31315,16320,14995,10348,5100,5248
391,1,16643000,3,50487,1,10767463,01/04/2022,16.2,39203,20881,18322,12964,6446,6518
392,1,19386000,3,50449,1,12550451,01/04/2022,20.5,58957,31503,27454,19229,9506,9723
393,2,32469000,2,84648,2,21020202,01/04/2022,16.8,62849,33939,28910,17954,8876,9078
394,1,17445000,3,34935,1,11304315,01/04/2022,17.2,25468,13582,11886,8293,4136,4157
395,1,19753000,3,46082,1,12793368,01/04/2022,16.2,31599,16595,15004,11708,5967,5741
396,1,26373000,2,52066,1,17090384,01/04/2022,16.2,29123,15247,13876,9589,4733,4856
397,1,14638000,3,26606,1,9488094,01/04/2022,16,18110,9443,8667,6325,3046,3279
398,1,10329000,3,39265,1,6674585,01/04/2022,16.2,31695,16422,15273,11280,5582,5698
399,1,14706000,3,33368,1,9525532,01/04/2022,16.2,95322,48884,46438,32521,16133,16388
400,1,14311000,3,27672,1,9274478,01/04/2022,16.2,9358,5013,4345,2738,1323,1415
401,1,11822000,3,48231,1,7636069,01/04/2022,17.9,9149,4948,4201,2691,1357,1334
402,1,3047000,3,23042,1,1957508,01/04/2022,16.2,9913,5282,4631,3496,1711,1785
403,1,9561000,3,10118,1,6204532,01/04/2022,16.2,36620,18819,17801,10303,4961,5342
404,1,1636000,3,24101,1,1039299,01/04/2022,16.2,5276,2719,2557,1830,893,937
405,1,16760000,3,27160,1,10866840,01/04/2022,16.2,41455,21994,19461,13993,6843,7150
406,1,14145000,3,24212,1,9170038,01/04/2022,18.2,29613,15403,14210,9414,4672,4742
408,1,9470000,3,23065,1,6132435,01/04/2022,18.1,13922,7166,6756,5211,2590,2621
409,1,3404000,3,21786,1,2190814,01/04/2022,16.2,10960,5789,5171,3556,1785,1771
410,1,10994000,3,27281,1,7118819,01/04/2022,14.8,22904,12086,10818,7644,3743,3901
411,1,7105000,3,23006,1,4595244,01/04/2022,16.2,11776,6077,5699,3730,1832,1898
412,1,1333000,3,9279,1,857171,01/04/2022,16.2,16797,8560,8237,5425,2652,2773
413,1,3175000,3,23433,1,2040317,01/04/2022,16.2,19648,10052,9596,6751,3334,3417
414,1,14440000,3,26708,1,9359292,01/04/2022,26.8,19341,10302,9039,6428,3158,3270
415,1,2536000,3,25209,1,1623191,01/04/2022,17.5,11487,6208,5279,3749,1855,1894
416,1,4403000,3,17746,1,2844204,01/04/2022,16.2,5703,2985,2718,1959,971,988
417,1,1936000,3,20249,1,1238151,01/04/2022,16.2,6644,3435,3209,2305,1130,1175
418,1,2796000,3,14822,1,1802578,01/04/2022,16.2,7491,3982,3509,2583,1266,1317
419,1,1609000,3,12550,1,1033300,01/04/2022,16.2,8481,4360,4121,2849,1391,1458
420,1,20471000,3,37814,1,13268336,01/04/2022,19.4,46996,24240,22756,12187,6012,6175
421,1,2150000,3,20587,1,1376913,01/04/2022,23,8445,4468,3977,3005,1505,1500
422,1,5659000,3,21749,1,3656601,01/04/2022,18.6,5612,3027,2585,1851,938,913
423,1,6294000,3,23676,1,4067424,01/04/2022,27.5,5276,2719,2557,1830,893,937
424,3,162673000,1,244550,3,105492900,01/04/2022,21.9,794789,407239,387550,199480,98049,101431
425,2,38937000,2,60259,2,25248791,01/04/2022,19.2,177719,91525,86194,50219,24680,25539
426,1,16326000,3,28141,1,10583759,01/04/2022,19.2,34955,18206,16749,9854,4805,5049
427,1,1885000,3,21929,1,1203321,01/04/2022,18.8,115264,60166,55098,28758,14392,14366
428,1,13901000,3,24600,1,9011050,01/04/2022,19.2,16795,8697,8098,5436,2628,2808
429,1,5197000,3,23530,1,3354520,01/04/2022,22.2,13390,6831,6559,4033,1966,2067
430,1,6979000,3,24328,1,4512022,01/04/2022,22.2,7953,4224,3729,2375,1195,1180
431,1,6434000,3,19629,1,4162471,01/04/2022,27.5,15512,8121,7391,5093,2493,2600
432,2,51935000,3,49248,2,33708502,01/04/2022,28.7,169028,86790,82238,45879,22689,23190
433,3,144849000,1,160349,3,93991501,01/04/2022,28.8,888797,441181,447616,247410,121384,126026
434,2,66138000,2,74980,2,42914720,01/04/2022,26.9,304942,149380,155562,85665,42398,43267
435,1,22524000,2,54678,1,14585922,01/04/2022,29.1,84519,42292,42227,24955,12440,12515
436,1,16693000,3,23192,1,10827258,01/04/2022,27.6,30754,15948,14806,10320,5221,5099
437,3,122942000,1,130388,3,79781912,01/04/2022,21.4,845941,437370,408571,227808,112567,115241
438,2,53127000,2,65706,2,34466844,01/04/2022,29.6,136351,71718,64633,38918,19062,19856
439,1,28278000,3,51816,1,18328884,01/04/2022,23.1,86686,44901,41785,27406,13467,13939
440,2,31575000,3,45828,2,20477922,01/04/2022,26.3,58158,30570,27588,17715,8934,8781
441,1,22303000,2,65648,1,14431302,01/04/2022,27.9,24258,12834,11424,7258,3602,3656
442,1,11702000,3,26578,1,7579722,01/04/2022,28.4,24454,12691,11763,7326,3576,3750
443,1,18307000,3,28943,1,11870607,01/04/2022,21.6,310192,159130,151062,94872,46787,48085
444,1,2710000,3,25697,1,1735803,01/04/2022,22.4,14340,7646,6694,4731,2430,2301
445,2,56134000,2,70836,2,36416264,01/04/2022,28.4,15341,8078,7263,4842,2416,2426
446,1,4793000,3,25767,1,3089683,01/04/2022,27.9,8045,4283,3762,2501,1247,1254
447,1,9490000,3,23611,1,6144889,01/04/2022,27.9,6644,3540,3104,2086,1058,1028
448,1,3410000,3,22294,1,2194206,01/04/2022,28.4,16582,8647,7935,5030,2477,2553
449,1,26217000,2,65838,1,16975212,01/04/2022,24.6,30796,15740,15056,9239,4503,4736
450,2,67140000,2,64784,2,43576216,01/04/2022,24,77849,40866,36983,21990,10871,11119
451,2,31427000,3,38671,2,20388879,01/04/2022,25.4,65215,33971,31244,19700,9733,9967
452,3,118963000,1,147610,3,77178340,01/04/2022,22.1,441975,227109,214866,122010,60145,61865
453,3,270554000,1,246873,3,175613227,01/04/2022,25.5,808416,416251,392165,234633,115277,119356
454,2,91698000,1,131525,2,59472175,01/04/2022,25.1,298009,154344,143665,83869,41238,42631
455,1,14939000,3,22059,1,9688291,01/04/2022,25.4,33924,17240,16684,10629,5267,5362
456,1,12551000,3,16366,1,8141784,01/04/2022,21.8,14772,7516,7256,4444,2199,2245
457,1,20326000,3,17764,1,13194136,01/04/2022,24.2,19742,9908,9834,6831,3367,3464
458,1,12325000,3,27411,1,7983839,01/04/2022,26.5,12848,6693,6155,3711,1831,1880
459,1,10754000,3,24008,1,6966092,01/04/2022,24,5457,2839,2618,1473,755,718
460,1,6210000,3,27056,1,4009444,01/04/2022,24.4,5926,3043,2883,1700,842,858
461,1,11283000,3,13075,1,7320875,01/04/2022,25.4,17097,8801,8296,5359,2662,2697
462,1,15727000,3,51863,1,10170687,01/04/2022,24.6,28239,14113,14126,8795,4312,4483
463,1,11634000,3,23337,1,7538763,01/04/2022,22.7,16934,8502,8432,5395,2626,2769
464,1,14486000,3,49299,1,9366601,01/04/2022,23.6,11851,5973,5878,3739,1841,1898
465,1,6721000,3,24309,1,4344341,01/04/2022,26.4,25157,12582,12575,8765,4230,4535
466,1,3390000,3,22027,1,2181473,01/04/2022,28.2,6055,3107,2948,1652,803,849
467,1,2924000,3,23386,1,1877214,01/04/2022,26.4,22421,11364,11057,6263,3134,3129
468,1,1990000,3,23874,1,1269626,01/04/2022,22.7,9864,5093,4771,3123,1529,1594
469,1,2789000,3,20600,1,1792250,01/04/2022,23.8,7888,4037,3851,3058,1509,1549
470,1,5270000,3,25662,1,3399838,01/04/2022,24,5524,2885,2639,1817,894,923
472,1,3146000,3,35280,1,2009620,01/04/2022,28.9,10328,5288,5040,3690,1794,1896
473,1,998000,3,2794,1,645906,01/04/2022,23.8,4810,2229,2581,1556,759,797
474,2,83932000,1,132256,2,54423544,01/04/2022,26.1,329404,168547,160857,90108,44605,45503
475,3,152111000,1,267435,3,98604715,01/04/2022,26.2,855563,431621,423942,240318,117646,122672
476,2,32626000,2,52222,2,21154678,01/04/2022,22.6,117253,59414,57839,33098,16300,16798
477,2,58966000,2,62946,2,38264954,01/04/2022,24.2,176685,87738,88947,53884,26504,27380
478,2,63504000,1,123038,2,41154562,01/04/2022,20.1,261137,131158,129979,84004,41439,42565
479,2,40656000,3,47899,2,26378501,01/04/2022,24.3,120926,61958,58968,34805,17098,17707
480,1,26570000,3,32324,1,17238176,01/04/2022,26.5,67604,34141,33463,21101,10330,10771
481,1,12453000,3,10048,1,8084402,01/04/2022,23.3,38886,19733,19153,11641,5731,5910
482,1,15724000,3,23355,1,10197245,01/04/2022,21.7,30324,15540,14784,8298,4088,4210
483,1,25071000,3,35781,1,16260369,01/04/2022,17,91029,45722,45307,30379,15003,15376
484,1,24241000,3,27321,1,15729329,01/04/2022,23.3,62301,30877,31424,20494,10127,10367
485,1,2373000,3,21706,1,1520744,01/04/2022,22,12987,6460,6527,4296,2156,2140
486,1,14125000,3,27889,1,9153361,01/04/2022,19.2,38113,19225,18888,12385,6138,6247
487,1,1949000,3,23042,1,1243808,01/04/2022,25.4,12372,6340,6032,3845,1851,1994
488,1,11922000,3,23094,1,7726206,01/04/2022,21.4,39474,19169,20305,14904,7336,7568
489,1,12783000,3,27317,1,8281633,01/04/2022,16.4,30429,15578,14851,9786,4826,4960
490,1,4766000,3,26111,1,3071789,01/04/2022,21.5,13153,6653,6500,4059,2009,2050
491,1,4851000,3,26261,1,3126889,01/04/2022,21.1,11440,5836,5604,4121,2095,2026
492,1,2090000,3,26073,1,1332427,01/04/2022,21.2,4787,2437,2350,1357,684,673
493,2,95944000,1,144393,2,62219207,01/04/2022,27.6,340060,178122,161938,86078,42456,43622
494,2,42069000,3,26548,2,27318302,01/04/2022,28.8,43035,22773,20262,11996,6054,5942
495,1,20621000,3,33543,1,13370107,01/04/2022,29.9,27182,14325,12857,8434,4220,4214
496,1,14890000,3,24532,1,9653968,01/04/2022,28.8,21003,10909,10094,6452,3209,3243
497,1,21428000,3,32728,1,13895472,01/04/2022,29.3,31435,16316,15119,9125,4445,4680
498,1,16228000,3,42906,1,10505294,01/04/2022,27,29068,15153,13915,8638,4280,4358
499,1,19493000,3,22532,1,12647918,01/04/2022,28.9,25555,13197,12358,7191,3479,3712
500,1,6241000,3,12162,1,4044488,01/04/2022,29.1,13944,7272,6672,4420,2177,2243
501,1,18289000,3,22059,1,11865791,01/04/2022,28.4,34946,17956,16990,11208,5422,5786
502,1,12246000,3,22892,1,7937008,01/04/2022,28.9,16679,8618,8061,4633,2284,2349
503,2,61367000,2,80922,2,39807628,01/04/2022,27,297373,155718,141655,71865,35366,36499
504,3,149397000,1,197622,3,96910428,01/04/2022,25.3,691557,348387,343170,213267,104895,108372
505,2,74939000,2,70727,2,48639623,01/04/2022,27.4,416055,211059,204996,132268,65355,66913
506,1,18582000,3,33491,1,12044809,01/04/2022,26.3,111314,55902,55412,35576,17423,18153
507,2,66701000,2,95463,2,43260187,01/04/2022,28.1,332100,171749,160351,94911,46503,48408
508,2,31564000,3,28500,2,20488100,01/04/2022,29.4,79515,41903,37612,21445,10720,10725
509,2,31851000,2,53618,2,20649532,01/04/2022,26.3,205933,107685,98248,49242,24249,24993
510,1,13229000,3,24944,1,8573906,01/04/2022,26.8,48172,24667,23505,15031,7399,7632
511,1,11449000,3,24432,1,7417418,01/04/2022,26.3,18592,8945,9647,4116,2046,2070
512,1,28562000,3,39265,1,18526035,01/04/2022,27.1,79824,40689,39135,24808,12213,12595
513,1,2191000,3,20349,1,1403801,01/04/2022,26.3,10327,5388,4939,2996,1506,1490
514,1,7550000,3,19635,1,4887865,01/04/2022,26.3,28215,14347,13868,9384,4582,4802
515,1,5765000,3,6587,1,3740663,01/04/2022,28,10993,5737,5256,3544,1803,1741
517,1,23447000,3,39970,1,15200580,01/04/2022,15.9,53373,27810,25563,15744,7755,7989
518,2,32722000,2,77109,2,21192191,01/04/2022,19.1,13555,7357,6198,3051,1547,1504
519,1,24977000,3,38718,1,16196332,01/04/2022,15.8,59871,31271,28600,19112,9469,9643
520,2,41778000,2,66834,2,27088866,01/04/2022,17.1,47632,25410,22222,12563,6265,6298
521,1,18634000,3,35415,1,12076685,01/04/2022,18.2,45587,23716,21871,14000,6913,7087
522,1,11964000,3,25960,1,7750640,01/04/2022,15.2,37704,19683,18021,12453,6131,6322
523,1,12761000,3,18766,1,8275884,01/04/2022,15.9,70224,35655,34569,24421,12033,12388
524,1,3067000,3,22310,1,1971240,01/04/2022,15.9,17978,9382,8596,6248,3105,3143
525,1,1469000,3,23838,1,931012,01/04/2022,15.9,13401,6929,6472,4288,2149,2139
526,1,1601000,3,16083,1,1024567,01/04/2022,15.9,30417,15670,14747,9405,4719,4686
527,1,6400000,3,33288,1,4126712,01/04/2022,15.9,28657,14853,13804,9078,4552,4526
528,1,928000,3,11206,1,591994,01/04/2022,15.9,1583,826,757,480,230,250
529,2,51797000,2,82778,2,33585272,01/04/2022,24.5,139075,74465,64610,36819,18286,18533
530,2,59371000,2,78680,2,38512470,01/04/2022,22.6,120500,65043,55457,29046,14403,14643
531,2,63240000,2,56954,2,41049046,01/04/2022,26.3,101336,54039,47297,24763,12096,12667
532,3,130651000,1,295580,3,84627570,01/04/2022,27.4,405952,215818,190134,89205,43880,45325
533,2,56970000,2,104244,2,36926256,01/04/2022,27.7,212540,111746,100794,51580,25268,26312
534,2,60281000,1,128587,2,39054063,01/04/2022,28,180057,96347,83710,45301,22589,22712
535,2,68406000,1,192849,2,44271051,01/04/2022,22,443063,237967,205096,110147,54509,55638
536,1,26025000,3,28552,1,16887698,01/04/2022,27.8,33226,17650,15576,10241,5095,5146
537,1,9058000,3,24777,1,5862923,01/04/2022,29.2,15512,8193,7319,4859,2440,2419
538,2,37603000,3,51016,2,24390934,01/04/2022,25.3,64445,34215,30230,17692,8626,9066
539,2,33654000,3,47067,2,21828033,01/04/2022,28.9,48567,25769,22798,13570,6693,6877
540,1,21122000,3,27740,1,13701560,01/04/2022,15.6,42451,22342,20109,14824,7241,7583
541,1,18797000,3,26865,1,12191185,01/04/2022,28.2,41588,21739,19849,12522,6161,6361
543,1,23034000,3,46987,1,14925113,01/04/2022,28,55452,29697,25755,14940,7380,7560
544,1,1560000,3,22304,1,991696,01/04/2022,27.4,6076,3180,2896,1703,844,859
545,2,39071000,2,59780,2,25336370,01/04/2022,28,64692,34002,30690,19678,9778,9900
546,1,1601000,3,21065,1,1019585,01/04/2022,27.2,22760,12125,10635,6420,3229,3191
547,1,14556000,3,34514,1,9426886,01/04/2022,26.7,25608,13480,12128,7723,3870,3853
548,1,10471000,2,52626,1,6753524,01/04/2022,25.3,15733,8506,7227,4079,2054,2025
549,1,6953000,3,24058,1,4495392,01/04/2022,22.6,41785,22480,19305,10854,5445,5409
550,1,9524000,3,36241,1,6154359,01/04/2022,27.6,13225,6946,6279,3476,1669,1807
551,1,14174000,3,34042,1,9179058,01/04/2022,20.2,28655,15243,13412,8764,4302,4462
552,1,6062000,3,35986,1,3904314,01/04/2022,27.8,17727,9423,8304,4199,2068,2131
553,1,12724000,2,92341,1,8178259,01/04/2022,29.2,8969,4883,4086,2821,1444,1377
554,1,10543000,3,24472,1,6828478,01/04/2022,29.6,16758,8967,7791,4993,2542,2451
555,2,31391000,3,46060,2,20358090,01/04/2022,27.5,47035,25085,21950,12872,6289,6583
556,1,17138000,3,26775,1,11112925,01/04/2022,26.4,55720,29557,26163,14521,7123,7398
557,1,19810000,3,30664,1,12845836,01/04/2022,27,46909,24866,22043,15156,7483,7673
558,1,13246000,3,31727,1,8578173,01/04/2022,27,33986,17827,16159,9043,4421,4622
559,1,14105000,3,23629,1,9144621,01/04/2022,22.6,34847,18666,16181,8943,4380,4563
560,1,14264000,3,35292,1,9236308,01/04/2022,27.9,14304,7545,6759,4455,2182,2273
561,1,8459000,3,23066,1,5475284,01/04/2022,27,20797,10995,9802,4991,2418,2573
562,1,15917000,3,22870,1,10323180,01/04/2022,27.2,30232,15727,14505,8913,4281,4632
563,1,23302000,2,60361,1,15085939,01/04/2022,27.2,20165,10621,9544,5395,2701,2694
564,1,2724000,3,20218,1,1750382,01/04/2022,28,20380,10692,9688,6259,3127,3132
565,1,10294000,3,22494,1,6668606,01/04/2022,18.4,21640,11976,9664,7433,3885,3548
566,1,18871000,3,31689,1,12234461,01/04/2022,18,33402,17876,15526,9753,4761,4992
567,1,23462000,3,44789,1,15205511,01/04/2022,27.1,26236,13620,12616,8067,3962,4105
568,1,3185000,3,23598,1,2046652,01/04/2022,29,4405,2358,2047,1451,735,716
569,1,3565000,3,26388,1,2290862,01/04/2022,27.8,13716,7109,6607,3981,1920,2061
570,1,11654000,3,24279,1,7550821,01/04/2022,27.9,5653,2987,2666,1709,826,883
571,1,9219000,3,28140,1,5964210,01/04/2022,23.6,21318,11472,9846,5688,2873,2815
572,1,10113000,3,25009,1,6548441,01/04/2022,27.9,14582,7621,6961,4539,2262,2277
573,1,1659000,3,29655,1,1048695,01/04/2022,28.4,6219,3311,2908,1883,941,942
574,1,8948000,3,33645,1,5782555,01/04/2022,28.3,31856,17018,14838,8563,4318,4245
575,1,15155000,3,25141,1,9825609,01/04/2022,22.6,35893,18883,17010,11399,5600,5799
576,1,16016000,3,25982,1,10384418,01/04/2022,23.6,19272,10328,8944,5163,2534,2629
577,1,14956000,3,27103,1,9694297,01/04/2022,15.2,16364,8711,7653,5250,2654,2596
578,1,10455000,3,24801,1,6770949,01/04/2022,27.4,2820,1449,1371,720,341,379
579,1,2175000,3,24114,1,1389636,01/04/2022,29.3,4654,2510,2144,1296,630,666
580,1,1302000,3,23137,1,823163,01/04/2022,15.2,21585,11243,10342,6456,3197,3259
581,1,1357000,3,25851,1,856199,01/04/2022,27.9,6888,3543,3345,1840,922,918
582,1,1616000,3,24397,1,1026003,01/04/2022,28.5,21391,11404,9987,5619,2742,2877
583,1,1514000,3,23310,1,960790,01/04/2022,27.2,9668,5030,4638,2384,1141,1243
584,1,17234000,3,24558,1,11177542,01/04/2022,28.3,13995,7311,6684,4212,2070,2142
585,1,4349000,3,24247,1,2802603,01/04/2022,26.4,6838,3583,3255,1791,891,900
586,1,1402000,3,23774,1,887526,01/04/2022,28.5,5681,3058,2623,1606,823,783
587,1,9234000,3,24917,1,5977183,01/04/2022,15.2,13966,7679,6287,3739,1859,1880
588,1,11921000,3,16999,1,7731651,01/04/2022,27.7,28076,14773,13303,7550,3752,3798
589,1,6128000,3,24808,1,3958392,01/04/2022,15.5,34039,18008,16031,8858,4334,4524
590,1,1793000,3,19451,1,1145999,01/04/2022,22.6,15807,8231,7576,5949,2955,2994
591,1,1120000,3,13345,1,714655,01/04/2022,26.4,10581,5508,5073,2907,1418,1489
592,1,3273000,3,22747,1,2104703,01/04/2022,19.6,9554,4935,4619,2707,1302,1405
593,1,11888000,3,47156,1,7680044,01/04/2022,27,9988,5342,4646,2237,1127,1110
594,1,2345000,3,14404,1,1509846,01/04/2022,28.1,7578,3984,3594,2088,1031,1057
595,1,2434000,3,22960,1,1559140,01/04/2022,20.1,8005,4106,3899,2599,1296,1303
596,1,2318000,3,21289,1,1485411,01/04/2022,27.7,24085,12288,11797,7909,3780,4129
597,1,3739000,3,22051,1,2408299,01/04/2022,28.5,7455,4054,3401,2223,1145,1078
598,1,942000,3,8676,1,603624,01/04/2022,28.4,17919,9538,8381,4548,2298,2250
599,1,4644000,3,24469,1,2994131,01/04/2022,28,15305,8066,7239,4706,2332,2374
600,3,135665000,1,240343,3,87941907,01/04/2022,29.9,921771,479309,442462,222551,109790,112761
601,1,13659000,3,23509,1,8854841,01/04/2022,27.1,26081,13338,12743,7626,3791,3835
602,1,27730000,3,23719,1,18000781,01/04/2022,28.7,56494,29131,27363,17460,8617,8843
603,1,15485000,3,27052,1,10038198,01/04/2022,26.7,52593,26982,25611,16883,8307,8576
604,1,5421000,3,31585,1,3492065,01/04/2022,27.6,41965,21110,20855,11192,5453,5739
605,1,9681000,3,30804,1,6261846,01/04/2022,29,26175,13553,12622,8885,4301,4584
606,1,11447000,3,26144,1,7414406,01/04/2022,29.2,35183,17868,17315,10650,5230,5420
607,1,9875000,3,24944,1,6393806,01/04/2022,27.4,56409,28489,27920,16919,8292,8627
608,1,8999000,3,12497,1,5836853,01/04/2022,30.2,139753,70456,69297,45077,22298,22779
609,1,6834000,3,22949,1,4419151,01/04/2022,28.1,17841,9042,8799,5372,2677,2695
610,1,6779000,3,19058,1,4387292,01/04/2022,30.2,28461,14574,13887,9148,4533,4615
611,2,35238000,2,62863,2,22841837,01/04/2022,20.9,143281,73905,69376,47529,23519,24010
612,2,38795000,2,101534,2,25115216,01/04/2022,18,138444,72335,66109,38201,18773,19428
613,1,11100000,3,24471,1,7190529,01/04/2022,21.2,22295,11690,10605,8176,4115,4061
614,1,11938000,3,48149,1,7711551,01/04/2022,19.3,25068,12776,12292,8673,4237,4436
615,1,2834000,3,25644,1,1816456,01/04/2022,20.3,15291,7886,7405,5051,2477,2574
616,1,5264000,3,23616,1,3397984,01/04/2022,20,38193,19467,18726,13775,6896,6879
617,1,9807000,3,26241,1,6348309,01/04/2022,20.1,46132,23831,22301,13972,6871,7101
618,1,1792000,3,21592,1,1143208,01/04/2022,24.9,13641,7027,6614,4307,2133,2174
1,2,93168000,1,167334,2,60391866,01/03/2022,19.7,863893,444725,419168,260350,128225,132125
2,1,15612000,3,26801,1,10120999,01/03/2022,18.2,31963,16433,15530,11390,5609,5781
3,1,9331000,3,23799,1,6041351,01/03/2022,18,63805,32406,31399,23397,11652,11745
4,1,8639000,3,23027,1,5592323,01/03/2022,18.2,21049,10874,10175,7097,3529,3568
5,1,4586000,3,25068,1,2955832,01/03/2022,17.2,32035,16367,15668,10989,5374,5615
6,3,194623000,1,247399,3,126257551,01/03/2022,21.6,854186,425977,428209,227917,112151,115766
7,3,374830000,1,510269,3,243129231,01/03/2022,15.9,1810645,899293,911352,503963,246971,256992
8,2,77038000,2,84363,2,49990337,01/03/2022,15.4,330652,167339,163313,86895,42903,43992
9,2,31587000,3,25707,2,20505843,01/03/2022,15.2,81059,40420,40639,23492,11470,12022
10,2,31566000,3,48033,2,20469867,01/03/2022,15,100660,49935,50725,28067,13772,14295
11,1,18982000,3,21771,1,12316529,01/03/2022,19.2,19081,9476,9605,5934,2909,3025
12,2,69405000,1,108592,2,45004658,01/03/2022,21.9,250141,126245,123896,65670,32312,33358
13,2,51665000,2,78578,2,33503672,01/03/2022,18.5,136285,66083,70202,42780,21001,21779
14,2,65944000,1,112502,2,42751098,01/03/2022,23.1,202694,98608,104086,64935,31858,33077
15,1,21727000,3,32347,1,14090203,01/03/2022,19.9,43805,22160,21645,13050,6507,6543
16,1,23425000,2,70092,1,15156158,01/03/2022,21.2,16311,8010,8301,4984,2435,2549
17,1,9397000,3,32048,1,6076002,01/03/2022,21,14357,6822,7535,3854,1925,1929
18,1,3119000,3,25479,1,2001871,01/03/2022,15.4,13596,6842,6754,4196,2086,2110
19,1,8031000,3,31193,1,5188957,01/03/2022,18.8,13596,6842,6754,4196,2086,2110
20,1,2959000,3,25087,1,1898263,01/03/2022,19.6,7185,3509,3676,2099,1015,1084
21,2,39344000,2,60691,2,25512909,01/03/2022,27.5,191238,97313,93925,52600,25862,26738
22,2,40873000,2,63673,2,26503777,01/03/2022,27.3,249623,130524,119099,66498,32635,33863
23,1,24911000,3,26550,1,16165600,01/03/2022,27.2,31375,16375,15000,10682,5317,5365
24,1,16632000,3,27671,1,10783129,01/03/2022,26.6,35799,18291,17508,11962,5883,6079
25,1,10990000,3,26334,1,7117166,01/03/2022,27.7,15949,8217,7732,4538,2234,2304
26,2,80771000,2,80142,2,52421008,01/03/2022,29.1,217550,113613,103937,65123,32048,33075
27,2,44498000,3,41808,2,28881892,01/03/2022,16.8,183509,96930,86579,60413,30246,30167
28,2,45572000,2,68310,2,29553490,01/03/2022,20.3,113479,60064,53415,36594,18199,18395
29,2,99359000,2,88720,2,64494630,01/03/2022,26.1,578830,303756,275074,166456,82025,84431
30,2,34504000,3,31993,2,22395607,01/03/2022,27.2,51797,27093,24704,17614,8812,8802
31,2,55508000,1,115015,2,35965185,01/03/2022,24.7,38087,20017,18070,11916,5833,6083
32,1,11818000,3,22117,1,7659583,01/03/2022,30.7,32109,16780,15329,10495,5074,5421
33,1,26177000,3,22159,1,16992891,01/03/2022,25.8,21727,11415,10312,7786,3890,3896
34,1,17612000,3,26935,1,11420865,01/03/2022,25.2,49201,25651,23550,16539,8102,8437
35,1,20882000,3,38784,1,13534516,01/03/2022,24.6,37546,19668,17878,11791,5836,5955
36,1,22953000,2,75056,1,14844394,01/03/2022,19,47688,25247,22441,17870,8920,8950
37,1,5185000,3,22890,1,3347360,01/03/2022,26.2,55931,28786,27145,18430,9082,9348
38,1,12064000,3,25824,1,7815776,01/03/2022,24.2,29018,15064,13954,10291,5191,5100
39,1,9319000,3,32791,1,6024559,01/03/2022,25.8,18219,9592,8627,5806,2838,2968
40,1,12874000,3,26470,1,8341630,01/03/2022,25.6,15244,8058,7186,4848,2429,2419
41,1,5128000,3,21608,1,3311592,01/03/2022,29.2,25366,13345,12021,7752,3823,3929
42,1,16655000,3,24428,1,10801322,01/03/2022,28.9,19271,9996,9275,6517,3095,3422
43,1,4234000,3,20364,1,2731736,01/03/2022,28.5,7662,4073,3589,2321,1153,1168
45,3,264626000,1,241173,3,171765727,01/03/2022,14.3,1501551,750157,751394,459910,225614,234296
46,3,101615000,1,175496,3,65874254,01/03/2022,15.8,925762,474776,450986,250961,123448,127513
47,1,28849000,3,49967,1,18701883,01/03/2022,18.6,128548,65838,62710,37721,18411,19310
48,1,23413000,3,39737,1,15178713,01/03/2022,13.8,135586,69677,65909,41627,20458,21169
49,2,30482000,2,55670,2,19757630,01/03/2022,17.2,113843,59214,54629,34117,16974,17143
50,1,5014000,3,21777,1,3237323,01/03/2022,20.2,23140,11693,11447,7155,3499,3656
51,1,9416000,3,23514,1,6096886,01/03/2022,16.4,35087,17902,17185,11563,5663,5900
52,1,12109000,3,32966,1,7837884,01/03/2022,17.4,42019,21548,20471,12599,6234,6365
53,1,10275000,3,40800,1,6637950,01/03/2022,17,22066,11231,10835,6719,3420,3299
54,1,8431000,3,32370,1,5447780,01/03/2022,8,17410,9121,8289,6393,3204,3189
55,1,1875000,3,22333,1,1196417,01/03/2022,27.3,22568,11549,11019,7200,3540,3660
56,1,5745000,3,22525,1,3711725,01/03/2022,10.4,15054,7516,7538,5557,2768,2789
57,1,3465000,2,70983,1,2181267,01/03/2022,13.9,8253,4210,4043,2801,1419,1382
58,1,4708000,3,33940,1,3026260,01/03/2022,10.8,7834,4065,3769,2439,1200,1239
59,1,1917000,3,28850,1,1217200,01/03/2022,5.9,14755,7617,7138,4907,2427,2480
60,1,11283000,3,31140,1,7302810,01/03/2022,13.1,62038,31762,30276,19262,9511,9751
61,2,95596000,1,117032,2,62020368,01/03/2022,22.4,690193,353744,336449,203574,99881,103693
62,3,126082000,1,168838,3,81784462,01/03/2022,17.5,864431,434753,429678,267728,131619,136109
63,2,39381000,2,52390,2,25545260,01/03/2022,21.5,237169,119538,117631,71348,35023,36325
64,2,47602000,2,77949,2,30863351,01/03/2022,22.8,173959,86825,87134,55826,27459,28367
65,1,9691000,3,22835,1,6276315,01/03/2022,18.3,39058,19755,19303,11201,5479,5722
66,3,113059000,1,179990,3,73308360,01/03/2022,20.8,59762,30506,29256,20025,9931,10094
67,1,14175000,3,35862,1,9177888,01/03/2022,20.9,49490,25496,23994,16916,8460,8456
68,1,27561000,3,51444,1,17863206,01/03/2022,18.6,160225,79799,80426,53549,26489,27060
69,1,15820000,3,16158,1,10266842,01/03/2022,16.5,114010,56192,57818,38156,18905,19251
70,1,24972000,3,40331,1,16191469,01/03/2022,20.1,75242,37695,37547,23792,11778,12014
71,1,11386000,3,24513,1,7376387,01/03/2022,18.4,59196,29915,29281,18125,8949,9176
72,1,14613000,3,27360,1,9471090,01/03/2022,20.9,32704,16713,15991,11320,5572,5748
73,1,6427000,3,23567,1,4153983,01/03/2022,18.3,23413,11884,11529,7157,3552,3605
74,1,8513000,3,22755,1,5510695,01/03/2022,18.7,38992,19602,19390,13022,6299,6723
75,1,1712000,3,17783,1,1095017,01/03/2022,21.6,27314,13703,13611,9005,4397,4608
76,2,52587000,2,60134,2,34121416,01/03/2022,25.2,146965,75962,71003,46271,22786,23485
77,2,29179000,3,42581,2,18923769,01/03/2022,26.5,88337,44762,43575,34686,17254,17432
78,2,41306000,2,60197,2,26788703,01/03/2022,24.2,159853,80569,79284,57402,28064,29338
79,1,2643000,3,21821,1,1696129,01/03/2022,25.7,9746,4912,4834,3336,1602,1734
80,1,1962000,3,23929,1,1251371,01/03/2022,24,15368,7632,7736,5699,2779,2920
81,1,1408000,3,8697,1,906503,01/03/2022,22.9,147496,76348,71148,49524,24280,25244
82,1,1047000,3,23851,1,656699,01/03/2022,24.1,14892,7420,7472,5365,2615,2750
83,1,7017000,3,25215,1,4535835,01/03/2022,18.8,34798,17459,17339,10865,5211,5654
84,2,38428000,1,183359,2,24794841,01/03/2022,19.1,432205,227255,204950,86717,42372,44345
85,2,40903000,1,164345,2,26422605,01/03/2022,19.1,759003,398068,360935,168014,83097,84917
86,2,93005000,1,301779,2,60151471,01/03/2022,19.8,1173351,609477,563874,261635,129105,132530
87,1,26885000,2,58417,1,17416833,01/03/2022,20.2,414470,219003,195467,75588,37198,38390
88,1,17231000,2,55093,1,11145057,01/03/2022,16.5,186693,97615,89078,46165,22603,23562
89,3,151946000,1,342788,3,98422112,01/03/2022,19.2,1835486,947835,887651,451632,222341,229291
90,2,53192000,1,116252,2,34458548,01/03/2022,19.3,614447,325337,289110,113945,55951,57994
91,1,26654000,2,80998,1,17244102,01/03/2022,18.7,434153,232032,202121,62030,30612,31418
92,2,54040000,1,113373,2,35012627,01/03/2022,17.8,323771,167274,156497,83659,40990,42669
93,2,43359000,2,74787,2,28108563,01/03/2022,17.2,404695,212343,192352,85496,42058,43438
94,1,25177000,1,146995,1,16218055,01/03/2022,18.6,443704,233586,210118,95713,47173,48540
95,2,63600000,1,260821,2,41079179,01/03/2022,19.3,545884,284933,260951,101794,50260,51534
96,1,14992000,2,56568,1,9688232,01/03/2022,17.2,429481,220393,209088,105785,52018,53767
97,1,9537000,3,45905,1,6153145,01/03/2022,13.2,246428,128767,117661,58169,28791,29378
98,1,12033000,3,27867,1,7793583,01/03/2022,13.2,599935,314284,285651,130174,64060,66114
99,3,116133000,1,156932,3,75329518,01/03/2022,17.3,616068,317266,298802,191866,94056,97810
100,2,70059000,2,77439,2,45460911,01/03/2022,16.1,301742,154079,147663,97495,48007,49488
101,1,9379000,3,19398,1,6076952,01/03/2022,19.6,96243,49040,47203,29383,14345,15038
102,1,15903000,3,41732,1,10295218,01/03/2022,18,30063,15334,14729,10450,5151,5299
103,1,1739000,2,91922,1,1038428,01/03/2022,22.7,3222,1654,1568,1247,637,610
104,1,12110000,2,71403,1,7800097,01/03/2022,15.6,17967,9205,8762,6003,2945,3058
105,1,2300000,3,20475,1,1474525,01/03/2022,16.1,11943,6311,5632,3854,1993,1861
106,1,2021000,2,92493,1,1221157,01/03/2022,18.9,12850,6538,6312,4678,2267,2411
107,2,34053000,2,99517,2,22034933,01/03/2022,9.3,26678,13733,12945,10032,4897,5135
108,3,162547000,1,237901,3,105417649,01/03/2022,14.3,223876,119352,104524,50306,24928,25378
109,2,57580000,1,173443,2,37253557,01/03/2022,15.6,515353,266081,249272,126007,61695,64312
110,2,92233000,1,313934,2,59637516,01/03/2022,16.8,776220,402522,373698,193769,95439,98330
111,2,57333000,2,88266,2,37178184,01/03/2022,16.3,84298,43745,40553,23019,11356,11663
112,2,43770000,2,55861,2,28394639,01/03/2022,15.2,30929,15848,15081,8319,4034,4285
113,2,29695000,1,115447,2,19186303,01/03/2022,16.1,293245,152241,141004,70657,34731,35926
114,2,56071000,1,234060,2,36212090,01/03/2022,15.5,658907,338453,320454,150053,73914,76139
115,1,22886000,3,21148,1,14854752,01/03/2022,15.5,117995,60165,57830,29983,14851,15132
116,3,157726000,1,292784,3,102229116,01/03/2022,13.9,1643623,845932,797691,437489,216020,221469
117,2,69079000,1,145930,2,44755420,01/03/2022,19.7,368585,190133,178452,107535,52900,54635
118,2,43443000,2,62436,2,28175514,01/03/2022,9.4,174704,91497,83207,54449,28355,26094
119,1,19488000,3,42235,1,12624965,01/03/2022,6.7,2931,1520,1411,975,512,463
120,2,50580000,2,100325,2,32776675,01/03/2022,10.5,35491,18986,16505,7987,3993,3994
121,2,60010000,1,146550,2,38859950,01/03/2022,16.3,703215,359601,343614,230612,113552,117060
122,2,57393000,1,169289,2,37136161,01/03/2022,18.5,18226,9300,8926,5308,2603,2705
123,2,47987000,2,53696,2,31137854,01/03/2022,17.7,1072676,556998,515678,265425,131078,134347
124,1,20696000,3,18663,1,13433737,01/03/2022,22.2,14038,7254,6784,3763,1910,1853
125,2,65099000,2,75137,2,42239213,01/03/2022,9.4,174704,91497,83207,54449,28355,26094
126,2,49386000,3,32682,2,32068218,01/03/2022,14.4,7077,3593,3484,1748,893,855
127,2,35690000,3,51634,2,23146866,01/03/2022,15.4,53362,27304,26058,15169,7515,7654
128,1,16628000,3,18149,1,10790051,01/03/2022,5.4,24612,12254,12358,7339,3541,3798
129,2,46040000,1,173924,2,29752076,01/03/2022,17,10873,5623,5250,3757,1878,1879
130,2,52543000,2,55920,2,34097030,01/03/2022,13.5,23219,12339,10880,6425,3186,3239
131,1,22732000,3,26475,1,14749325,01/03/2022,16.6,12671,6512,6159,3454,1710,1744
132,1,19643000,3,31373,1,12736577,01/03/2022,11.1,30967,16277,14690,10756,5327,5429
133,2,37399000,2,53622,2,24255728,01/03/2022,18.9,323545,166328,157217,93932,46757,47175
134,1,6200000,3,18213,1,4011787,01/03/2022,22.3,19326,10155,9171,6252,3129,3123
135,1,20093000,3,33147,1,13027303,01/03/2022,9.4,33716,17686,16030,9317,4624,4693
136,1,11894000,3,49342,1,7681758,01/03/2022,15.4,40279,20716,19563,10282,5078,5204
137,1,4293000,3,20777,1,2769673,01/03/2022,16.5,29068,14916,14152,8580,4220,4360
138,1,28384000,2,55060,1,18394540,01/03/2022,18.4,12752,6694,6058,3471,1768,1703
139,1,4399000,3,47231,1,2812119,01/03/2022,15,33166,16973,16193,9497,4707,4790
140,1,6268000,3,10628,1,4063572,01/03/2022,15.5,52828,27143,25685,16500,8128,8372
141,1,28138000,3,24093,1,18265607,01/03/2022,15.8,32738,16941,15797,9059,4431,4628
142,1,10417000,3,24806,1,6746244,01/03/2022,16.5,30203,15792,14411,7568,3777,3791
143,1,28385000,3,35736,1,18414514,01/03/2022,15.5,11760,6069,5691,3432,1700,1732
144,1,10865000,3,18338,1,7043912,01/03/2022,17.7,72525,37076,35449,22128,10944,11184
145,1,7556000,3,25454,1,4885946,01/03/2022,6.7,18580,9729,8851,5724,2801,2923
146,1,18590000,3,28021,1,12055479,01/03/2022,18.5,24575,12798,11777,7126,3453,3673
147,1,1281000,3,19954,1,812696,01/03/2022,16.1,44731,22925,21806,13335,6514,6821
148,1,8057000,3,51810,1,5185240,01/03/2022,16.2,658907,338453,320454,150053,73914,76139
149,1,13462000,3,27159,1,8723141,01/03/2022,15.9,10336,5387,4949,3449,1664,1785
150,1,11264000,3,20240,1,7301360,01/03/2022,14.4,4656,2421,2235,1533,751,782
151,1,6266000,3,25716,1,4047184,01/03/2022,18.9,9598,5002,4596,2910,1467,1443
152,1,9206000,3,17696,1,5966204,01/03/2022,15.5,15171,7853,7318,4470,2251,2219
153,1,5750000,3,23633,1,3713867,01/03/2022,16.5,10792,5577,5215,3492,1713,1779
154,1,2125000,3,3546,1,1377704,01/03/2022,15.5,37442,19141,18301,12089,5963,6126
155,1,3775000,3,25250,1,2428500,01/03/2022,9.4,17736,9182,8554,5577,2775,2802
156,1,7801000,3,9050,1,5061600,01/03/2022,18.5,386290,199249,187041,112223,55337,56886
157,1,8776000,3,28357,1,5676043,01/03/2022,18.5,9925,5218,4707,2833,1403,1430
158,1,8093000,3,23696,1,5236754,01/03/2022,22.2,6944,3666,3278,2341,1149,1192
159,1,7243000,3,17878,1,4690072,01/03/2022,13.9,88734,45471,43263,28316,14166,14150
160,1,7336000,3,18823,1,4749577,01/03/2022,10.5,6449,3346,3103,1687,833,854
161,1,5400000,3,17551,1,3492449,01/03/2022,13.7,10735,5576,5159,3010,1518,1492
162,1,2324000,3,20223,1,1490377,01/03/2022,10.5,10810,5614,5196,2941,1451,1490
163,1,238000,3,2086,1,152614,01/03/2022,25.5,13038,6614,6424,4157,2015,2142
165,3,160064000,1,225100,3,103816500,01/03/2022,21.8,1579803,804212,775591,594938,292494,302444
166,2,69796000,2,62085,2,45305315,01/03/2022,17.1,378143,194849,183294,128863,62806,66057
167,2,66576000,2,63560,2,43210840,01/03/2022,21.9,452090,230346,221744,162764,80177,82587
168,1,19906000,3,35297,1,12903603,01/03/2022,20.4,69371,35473,33898,25304,12303,13001
169,1,27905000,3,46655,1,18091595,01/03/2022,18.7,79772,40908,38864,30907,15312,15595
170,1,22503000,3,35923,1,14591027,01/03/2022,19.6,56597,29703,26894,19146,9514,9632
171,1,21385000,3,30979,1,13869271,01/03/2022,17.8,72663,38036,34627,27395,13712,13683
172,2,42237000,2,77313,2,27376737,01/03/2022,20.2,160682,83178,77504,52342,25860,26482
173,1,26938000,3,34288,1,17475412,01/03/2022,17.8,83352,42766,40586,32937,16375,16562
174,1,28686000,3,31970,1,18613930,01/03/2022,16.9,67101,35567,31534,27008,13393,13615
175,1,16215000,3,28393,1,10511357,01/03/2022,20.1,43249,22352,20897,17065,8284,8781
176,1,22890000,3,38250,1,14840250,01/03/2022,17,51894,27702,24192,20579,10113,10466
177,1,21626000,3,47338,1,14009562,01/03/2022,19.6,70068,36526,33542,21044,10402,10642
178,1,18552000,3,25668,1,12033132,01/03/2022,18.9,52156,27081,25075,17108,8394,8714
179,1,4035000,3,24876,1,2597874,01/03/2022,21.4,41910,21741,20169,12631,6146,6485
180,1,19534000,3,47495,1,12649605,01/03/2022,18.1,43998,23109,20889,17575,8775,8800
181,1,4707000,3,25135,1,3034415,01/03/2022,21.2,24757,12827,11930,9816,4898,4918
182,1,3721000,3,19579,1,2399071,01/03/2022,18.7,21756,11234,10522,8659,4317,4342
183,1,7250000,3,9050,1,4703450,01/03/2022,18.1,28109,14419,13690,10548,5187,5361
184,1,5195000,3,23494,1,3353256,01/03/2022,18.2,15305,7996,7309,5899,2872,3027
185,1,25094000,3,36044,1,16275056,01/03/2022,18.1,72452,38019,34433,23628,11618,12010
186,1,16899000,3,25030,1,10959320,01/03/2022,18.6,35401,18444,16957,12235,5945,6290
187,1,22244000,3,36711,1,14421889,01/03/2022,19.2,27593,14289,13304,10803,5260,5543
188,1,17204000,3,22460,1,11160140,01/03/2022,19.7,31264,16171,15093,9806,4840,4966
189,1,15785000,3,35842,1,10224408,01/03/2022,15.5,24228,12861,11367,9383,4674,4709
190,1,17936000,3,25292,1,11633108,01/03/2022,15.2,32831,17049,15782,13856,6706,7150
191,1,2395000,3,22798,1,1533952,01/03/2022,20.4,16092,8507,7585,6837,3451,3386
192,1,6839000,3,27678,1,4417672,01/03/2022,19,8011,4268,3743,3134,1562,1572
193,1,13416000,3,24282,1,8696118,01/03/2022,21.6,29002,14796,14206,11206,5550,5656
194,1,2749000,3,26470,1,1760380,01/03/2022,17.1,7946,4172,3774,3293,1607,1686
195,1,9380000,3,9129,1,6087871,01/03/2022,21.2,28260,14728,13532,11002,5473,5529
196,1,5674000,3,5521,1,3682579,01/03/2022,18.9,25845,13471,12374,9370,4627,4743
197,3,138295000,1,173178,3,89718572,01/03/2022,25.8,658609,345979,312630,183298,90145,93153
198,2,52436000,2,55542,2,34027858,01/03/2022,23,225728,119129,106599,71494,35347,36147
199,2,33139000,3,41395,2,21498955,01/03/2022,28.7,70760,36613,34147,21788,10705,11083
200,2,39637000,2,76995,2,25687055,01/03/2022,27.5,132854,69610,63244,41183,20301,20882
201,1,16500000,2,54979,1,10670021,01/03/2022,23.2,50399,26542,23857,14000,6918,7082
202,1,2696000,3,25515,1,1726885,01/03/2022,25.2,27944,14419,13525,9490,4664,4826
203,1,5455000,3,26626,1,3519124,01/03/2022,16.4,22534,11802,10732,7926,3939,3987
204,1,13414000,3,27985,1,8691115,01/03/2022,26.4,25148,13436,11712,8928,4476,4452
205,1,22231000,3,26992,1,14423158,01/03/2022,20.9,33783,18241,15542,12201,6089,6112
206,2,30371000,3,28143,2,19713007,01/03/2022,29.2,25850,13268,12582,8390,4048,4342
208,2,29675000,3,32763,2,19255987,01/03/2022,20,27607,14605,13002,9883,5002,4881
209,1,8861000,3,25867,1,5733783,01/03/2022,25.7,13866,7187,6679,4383,2099,2284
210,1,6875000,3,25523,1,4443227,01/03/2022,26.8,23363,12127,11236,7776,3818,3958
211,1,14120000,3,31353,1,9146647,01/03/2022,25.6,18224,9500,8724,7072,3514,3558
212,1,12954000,3,24306,1,8395794,01/03/2022,26.4,16447,8464,7983,4843,2381,2462
213,1,5943000,3,12597,1,3850353,01/03/2022,24.1,17550,9283,8267,5700,2861,2839
214,2,64757000,1,151881,2,41940169,01/03/2022,17.3,297848,156299,141549,74787,37046,37741
215,1,25696000,3,18356,1,16684044,01/03/2022,18.4,29390,15521,13869,7939,3942,3997
216,2,31419000,2,66051,2,20356299,01/03/2022,18.6,37608,20094,17514,11115,5490,5625
217,2,35117000,2,65502,2,22760548,01/03/2022,18.2,106163,56161,50002,30752,15034,15718
218,1,13384000,3,23800,1,8675800,01/03/2022,16.1,11149,5894,5255,2996,1479,1517
219,2,35224000,3,50007,2,22845593,01/03/2022,14,60265,30945,29320,18808,9224,9584
220,1,18729000,3,31588,1,12142262,01/03/2022,19,17718,9411,8307,4913,2492,2421
221,1,16634000,3,37012,1,10775088,01/03/2022,17.8,36618,19077,17541,10530,5273,5257
222,1,11042000,3,21907,1,7155393,01/03/2022,20.9,9853,5224,4629,2757,1390,1367
223,1,2767000,3,25963,1,1772587,01/03/2022,18.4,27713,14561,13152,7736,3885,3851
224,1,6633000,3,23630,1,4287820,01/03/2022,17.3,32276,17014,15262,9457,4578,4879
225,1,7737000,3,23563,1,5005487,01/03/2022,20.9,14689,7582,7107,4123,2033,2090
226,2,36754000,3,44935,2,23845165,01/03/2022,23.1,44311,23331,20980,13756,6771,6985
227,1,4162000,3,25032,1,2680268,01/03/2022,18.6,14732,7791,6941,4911,2433,2478
228,1,10125000,3,23885,1,6557365,01/03/2022,17.6,20530,10890,9640,6356,3180,3176
229,1,11329000,3,21815,1,7342035,01/03/2022,22,16368,8558,7810,4728,2323,2405
230,1,8848000,3,21506,1,5729694,01/03/2022,13.8,6213,3216,2997,1786,871,915
231,1,10088000,3,21401,1,6535799,01/03/2022,14,28792,15288,13504,8327,4111,4216
233,1,4578000,3,5145,1,2970555,01/03/2022,20.2,8657,4501,4156,2464,1200,1264
234,2,61442000,2,102553,2,39834747,01/03/2022,20.4,224166,112147,112019,65088,31954,33134
235,1,26881000,2,65047,1,17407603,01/03/2022,17.7,111569,57370,54199,36412,17892,18520
236,1,23526000,3,32301,1,15259599,01/03/2022,20,38780,20122,18658,13025,6461,6564
237,3,137579000,1,322522,3,89103828,01/03/2022,20.9,1385621,718628,666993,333198,164217,168981
238,2,95209000,1,237479,2,61648371,01/03/2022,19.6,1257547,645398,612149,321993,158559,163434
239,1,19416000,3,31250,1,12589150,01/03/2022,19.9,37871,19554,18317,11359,5732,5627
240,2,78030000,1,191352,2,50528148,01/03/2022,22.5,650123,329365,320758,200033,98558,101475
241,2,37484000,2,66826,2,24297774,01/03/2022,19.2,111975,57735,54240,31481,15460,16021
242,1,11670000,3,22523,1,7562977,01/03/2022,20,98842,50427,48415,30938,15263,15675
243,2,57446000,1,178051,2,37161849,01/03/2022,18.2,44103,22420,21683,15768,7755,8013
244,1,9670000,3,27697,1,6257803,01/03/2022,16.1,53539,27205,26334,18000,8916,9084
245,1,10914000,3,25396,1,7068704,01/03/2022,25.3,18787,9476,9311,6502,3270,3232
246,1,14757000,3,33350,1,9558700,01/03/2022,20,59648,30609,29039,19344,9536,9808
247,2,52055000,2,98645,2,33737105,01/03/2022,19.2,30471,15635,14836,9610,4654,4956
248,1,3547000,3,25300,1,2280250,01/03/2022,20.5,20286,10307,9979,6804,3413,3391
249,1,3490000,3,22410,1,2246090,01/03/2022,22.8,20345,10131,10214,6733,3300,3433
250,1,18010000,3,38156,1,11668344,01/03/2022,20.1,31115,15891,15224,10525,5240,5285
251,1,11774000,3,44978,1,7608122,01/03/2022,20.5,16550,8456,8094,5252,2552,2700
252,1,14587000,3,24532,1,9457018,01/03/2022,22.2,24352,12627,11725,8092,4062,4030
253,1,20347000,3,37070,1,13188480,01/03/2022,17.8,94978,48709,46269,29794,14672,15122
254,1,23090000,3,26400,1,14982100,01/03/2022,22.5,52019,26739,25280,15725,7759,7966
255,1,3661000,3,23287,1,2356363,01/03/2022,19.8,24580,12765,11815,8215,4057,4158
256,1,11519000,3,23560,1,7463790,01/03/2022,19.5,28678,14679,13999,9074,4497,4577
257,1,3895000,3,23027,1,2508723,01/03/2022,15.7,22738,11719,11019,7000,3537,3463
258,1,9704000,3,23441,1,6284159,01/03/2022,19.2,28145,14670,13475,8863,4390,4473
259,1,7319000,3,28272,1,4729078,01/03/2022,19.2,19113,9852,9261,5504,2716,2788
260,1,1901000,3,23401,1,1212249,01/03/2022,16.1,25925,13382,12543,8585,4189,4396
261,1,865000,3,22798,1,539452,01/03/2022,19.5,13033,6697,6336,4420,2181,2239
262,1,2957000,3,22275,1,1899775,01/03/2022,10.9,5955,3118,2837,1972,974,998
263,1,1449000,3,20147,1,921703,01/03/2022,20.1,8850,4524,4326,2773,1377,1396
264,1,1848000,3,21211,1,1179989,01/03/2022,15.7,9529,4943,4586,3018,1490,1528
265,1,8333000,3,26334,1,5390116,01/03/2022,16.1,14636,7533,7103,4910,2424,2486
266,1,14758000,3,33910,1,9558790,01/03/2022,20.5,40906,20800,20106,12864,6409,6455
267,1,5905000,3,25474,1,3812776,01/03/2022,19.2,8142,4289,3853,2686,1333,1353
268,1,1898000,3,22410,1,1211290,01/03/2022,15.7,7954,4060,3894,2570,1274,1296
269,1,9984000,3,24732,1,6464868,01/03/2022,20.1,17000,8527,8473,5215,2549,2666
270,1,3185000,3,22454,1,2047796,01/03/2022,17.4,14424,7439,6985,5399,2678,2721
271,1,2431000,3,23265,1,1556885,01/03/2022,20.1,16873,8725,8148,6022,3008,3014
272,1,2270000,3,17972,1,1457528,01/03/2022,19.2,5109,2618,2491,1631,805,826
273,1,2421000,3,23242,1,1550408,01/03/2022,19.2,13243,6795,6448,4043,1954,2089
274,1,2358000,3,21698,1,1511002,01/03/2022,16.1,14497,7627,6870,4260,2099,2161
275,1,2056000,3,19343,1,1317057,01/03/2022,21.4,16324,8373,7951,5562,2774,2788
276,1,4663000,3,25050,1,3005900,01/03/2022,24.8,9842,5047,4795,3323,1629,1694
277,1,3160000,3,21910,1,2032090,01/03/2022,16.1,27833,14525,13308,9097,4581,4516
278,1,4003000,3,5324,1,2596626,01/03/2022,21.4,33284,17172,16112,10804,5349,5455
279,1,1810000,3,21931,1,1154569,01/03/2022,23.2,14697,7601,7096,4740,2380,2360
280,1,3482000,3,19227,1,2244073,01/03/2022,17.8,18607,9363,9244,6403,3178,3225
284,2,98639000,1,163199,2,63952151,01/03/2022,21.6,743275,388114,355161,202467,99875,102592
285,2,37512000,2,90089,2,24292711,01/03/2022,19.6,154546,80401,74145,48513,24003,24510
286,2,64014000,2,96976,2,41512124,01/03/2022,18.5,299523,155411,144112,93845,46362,47483
287,2,43473000,2,61854,2,28195596,01/03/2022,24.8,83637,42325,41312,24783,12286,12497
288,2,39322000,2,66268,2,25493032,01/03/2022,27.4,102362,52461,49901,35162,17416,17746
289,1,16203000,3,33473,1,10498477,01/03/2022,19.9,55287,28877,26410,16959,8447,8512
290,1,19745000,3,38816,1,12795434,01/03/2022,21.5,87042,45232,41810,26414,12958,13456
291,2,36560000,2,55954,2,23708046,01/03/2022,10.4,86901,45620,41281,26262,13160,13102
292,1,19639000,3,22755,1,12742595,01/03/2022,20.3,30519,15931,14588,10809,5325,5484
293,2,29634000,3,33956,2,19228144,01/03/2022,16.7,60811,31893,28918,19713,9706,10007
294,1,3583000,3,9398,1,2319552,01/03/2022,15.9,61510,31765,29745,21000,10487,10513
295,1,21236000,3,49033,1,13754367,01/03/2022,18.1,70042,36241,33801,21818,10809,11009
296,1,4108000,3,9523,1,2660677,01/03/2022,18,24662,12965,11697,6937,3350,3587
297,1,6250000,3,20117,1,4042383,01/03/2022,15.9,15414,7999,7415,4635,2291,2344
298,1,21357000,3,24532,1,13857518,01/03/2022,16.8,71528,37497,34031,23278,11539,11739
299,1,2211000,3,23835,1,1413315,01/03/2022,20.3,15249,7932,7317,4894,2453,2441
300,1,25200000,3,24088,1,16355912,01/03/2022,17.5,39425,20578,18847,13203,6477,6726
301,1,3595000,3,25058,1,2311692,01/03/2022,18,17293,8766,8527,5650,2795,2855
302,1,11356000,3,24532,1,7356868,01/03/2022,10.4,16905,8772,8133,5514,2740,2774
303,1,3710000,3,22683,1,2388817,01/03/2022,16.7,18097,9360,8737,5881,2892,2989
304,1,12554000,3,23966,1,8136134,01/03/2022,20.1,32333,16690,15643,10314,5057,5257
305,1,17856000,3,25867,1,11580533,01/03/2022,18.6,49940,25545,24395,16071,7998,8073
306,1,15789000,3,25908,1,10236942,01/03/2022,16.8,1049,546,503,282,149,133
307,1,13441000,3,24535,1,8712115,01/03/2022,19,6853,3584,3269,2311,1149,1162
308,1,6443000,3,4432,1,4183518,01/03/2022,26.6,12262,6119,6143,4251,2104,2147
309,1,1716000,3,28848,1,1086552,01/03/2022,18.6,11086,5609,5477,3615,1780,1835
311,2,49699000,1,136402,2,32167948,01/03/2022,24.4,341029,180370,160659,82444,40670,41774
312,2,68790000,2,96337,2,44617163,01/03/2022,24.2,157336,82380,74956,43883,21497,22386
313,1,22470000,3,9106,1,14596394,01/03/2022,27,174629,91268,83361,46521,22880,23641
314,2,29524000,3,45643,2,19144957,01/03/2022,25.3,104461,54150,50311,30967,15315,15652
315,1,15126000,3,47849,1,9784051,01/03/2022,24.4,44353,23038,21315,13070,6400,6670
316,1,4785000,3,25400,1,3084850,01/03/2022,26.6,21375,11206,10169,5662,2753,2909
317,2,31584000,3,38947,2,20490653,01/03/2022,26.8,17777,9225,8552,4254,2086,2168
318,2,37260000,2,91171,2,24127829,01/03/2022,27,64084,32934,31150,19785,9668,10117
319,1,14160000,3,26924,1,9177076,01/03/2022,25.5,20434,10867,9567,5939,2970,2969
320,1,13471000,3,25114,1,8731036,01/03/2022,19.6,19085,9763,9322,6343,3119,3224
321,2,90735000,1,115814,2,58861936,01/03/2022,19,371387,192530,178857,106784,52432,54352
322,1,20117000,3,21778,1,13054272,01/03/2022,20,18023,9240,8783,5154,2503,2651
323,1,12019000,3,43926,1,7768424,01/03/2022,21,20322,10479,9843,6201,3025,3176
324,1,17156000,3,28831,1,11122569,01/03/2022,21,25477,13300,12177,8208,4059,4149
325,1,8367000,3,48894,1,5389656,01/03/2022,22.1,13620,7015,6605,4098,1994,2104
326,1,12163000,3,24290,1,7881660,01/03/2022,21,48170,25016,23154,15515,7657,7858
327,1,8777000,3,41715,1,5663335,01/03/2022,25.3,10593,5340,5253,3485,1705,1780
328,2,35761000,2,72411,2,23172239,01/03/2022,20,8730,4395,4335,2894,1447,1447
329,1,4459000,3,23630,1,2874720,01/03/2022,22.9,14678,7367,7311,4863,2405,2458
330,1,7317000,3,23106,1,4732944,01/03/2022,20,10935,5450,5485,3532,1706,1826
331,1,8718000,3,22513,1,5644187,01/03/2022,23,19976,10345,9631,6431,3120,3311
332,2,54072000,2,98194,2,35048606,01/03/2022,20.1,412199,209241,202958,82879,40585,42294
333,2,53764000,1,119017,2,34827583,01/03/2022,21.1,304052,152635,151417,84118,41457,42661
334,2,81015000,1,131546,2,52528204,01/03/2022,18.4,536436,267279,269157,158598,77797,80801
335,3,107973000,1,134904,3,70047546,01/03/2022,18.4,635862,320627,315235,153834,75737,78097
336,3,130783000,1,210551,3,84798399,01/03/2022,18.8,1142952,578172,564780,270109,132170,137939
338,1,14488000,3,45612,1,9371588,01/03/2022,18.4,75721,38037,37684,21903,10795,11108
339,1,17887000,3,33354,1,11593196,01/03/2022,20.9,70378,35870,34508,21367,10464,10903
340,2,39799000,3,22924,2,25846426,01/03/2022,15,308285,152976,155309,108145,53196,54949
342,2,35667000,2,62781,2,23120769,01/03/2022,17.5,234698,115478,119220,87040,43098,43942
343,1,11578000,3,27547,1,7498153,01/03/2022,18.4,28843,14318,14525,8529,4190,4339
344,1,10892000,3,25426,1,7054374,01/03/2022,20.4,33522,17126,16396,9330,4711,4619
345,1,14547000,3,46974,1,9408576,01/03/2022,18.7,54467,27606,26861,15858,7789,8069
346,1,14012000,3,19945,1,9087855,01/03/2022,20.1,13059,6525,6534,4137,2073,2064
347,1,1241000,3,3850,1,802800,01/03/2022,15,9934,4952,4982,3082,1558,1524
348,1,5033000,3,25850,1,3245600,01/03/2022,15,7844,4131,3713,2621,1355,1266
349,1,8194000,3,48470,1,5277630,01/03/2022,18.4,48069,23121,24948,16392,8040,8352
350,1,8782000,3,22310,1,5685990,01/03/2022,21.1,11583,5810,5773,3713,1872,1841
351,1,4691000,3,20479,1,3028671,01/03/2022,25.4,29903,15539,14364,9778,4798,4980
352,3,130640000,1,249927,3,84666073,01/03/2022,24.3,258913,138803,120110,68042,33683,34359
353,2,47350000,2,80766,2,30696734,01/03/2022,25.6,103609,54904,48705,31555,15575,15980
354,1,27992000,2,68980,1,18125820,01/03/2022,27.9,76660,40113,36547,21596,10646,10950
355,2,36865000,3,49437,2,23912813,01/03/2022,29.1,88280,46038,42242,25864,12608,13256
356,1,28243000,2,55895,1,18302055,01/03/2022,21.1,56163,29689,26474,18214,8872,9342
357,1,2715000,3,29221,1,1735529,01/03/2022,25.6,7263,3837,3426,2540,1279,1261
358,1,14290000,3,23300,1,9265200,01/03/2022,27.1,16645,8759,7886,5075,2484,2591
359,1,12812000,3,50066,1,8277734,01/03/2022,24.4,31469,16729,14740,9837,4899,4938
360,1,13636000,3,22772,1,8840628,01/03/2022,16.5,12729,6935,5794,4541,2296,2245
361,1,13169000,3,25477,1,8534373,01/03/2022,29.1,26015,13735,12280,7360,3633,3727
362,2,40912000,3,27585,2,26565215,01/03/2022,25.4,29903,15539,14364,9778,4798,4980
363,1,25403000,3,39748,1,16472202,01/03/2022,27.5,10504,5405,5099,3440,1722,1718
364,1,17357000,3,23730,1,11258320,01/03/2022,28.2,45134,23442,21692,13494,6690,6804
365,1,21322000,3,47454,1,13811846,01/03/2022,19.5,29130,15431,13699,9957,5019,4938
366,1,4379000,3,19640,1,2826710,01/03/2022,24.2,5812,3105,2707,1767,906,861
367,1,12780000,3,24004,1,8282996,01/03/2022,16.5,15851,8463,7388,5625,2839,2786
368,1,4885000,3,23530,1,3151720,01/03/2022,19.5,15298,8185,7113,4499,2268,2231
369,1,27354000,3,27811,1,17752289,01/03/2022,29.1,17525,9370,8155,5075,2488,2587
370,1,18998000,2,70554,1,12278146,01/03/2022,16.5,18915,10248,8667,6395,3217,3178
371,1,19885000,3,20565,1,12904685,01/03/2022,21.9,81848,43535,38313,23849,11894,11955
372,2,35361000,3,34491,2,22950159,01/03/2022,22.3,33726,17513,16213,11096,5372,5724
373,1,2103000,3,19888,1,1347062,01/03/2022,19.5,11168,5931,5237,3889,1954,1935
374,1,4630000,3,23496,1,2986004,01/03/2022,25.6,6341,3343,2998,2049,979,1070
375,1,20251000,3,13286,1,13149864,01/03/2022,21.9,45895,23816,22079,12162,5997,6165
376,1,5477000,3,27185,1,3532865,01/03/2022,25.4,6863,3664,3199,2612,1321,1291
377,1,9541000,3,24091,1,6177559,01/03/2022,22.3,10611,5602,5009,3876,1871,2005
378,1,3282000,3,24827,1,2108473,01/03/2022,27.1,14226,7514,6712,4380,2214,2166
379,1,4626000,3,20350,1,2986550,01/03/2022,21.9,7997,4114,3883,2359,1161,1198
380,1,1884000,3,9473,1,1215127,01/03/2022,24.4,4188,2243,1945,1509,761,748
381,1,27878000,2,57145,1,18063555,01/03/2022,25.4,15373,8115,7258,5203,2638,2565
382,1,15786000,3,23181,1,10237719,01/03/2022,27.8,14071,7408,6663,4497,2251,2246
383,1,2092000,3,20341,1,1339459,01/03/2022,15.8,6642,3720,2922,2058,1005,1053
384,1,6663000,3,6329,1,4324621,01/03/2022,26.9,11054,5638,5416,3563,1745,1818
385,3,197743000,1,398656,3,128134294,01/03/2022,18.6,1542232,806262,735970,402209,198130,204079
386,2,44924000,2,56964,2,29143636,01/03/2022,16.2,78264,40929,37335,23163,11368,11795
387,2,58033000,2,71777,2,37649673,01/03/2022,20,293825,155300,138525,93203,46206,46997
388,1,25052000,3,42307,1,16241493,01/03/2022,26.8,49578,26095,23483,16381,8171,8210
389,2,32826000,3,34295,2,21302605,01/03/2022,19.8,89314,47398,41916,25892,12760,13132
390,2,39215000,3,32798,2,25456952,01/03/2022,17.6,31315,16320,14995,10348,5100,5248
391,1,17215000,3,47057,1,11142693,01/03/2022,14.2,39203,20881,18322,12964,6446,6518
392,1,19839000,3,47640,1,12847710,01/03/2022,17.6,58957,31503,27454,19229,9506,9723
393,2,32238000,2,79751,2,20874949,01/03/2022,14,62849,33939,28910,17954,8876,9078
394,1,17212000,3,33530,1,11154270,01/03/2022,15.1,25468,13582,11886,8293,4136,4157
395,1,20337000,3,44816,1,13174234,01/03/2022,14.2,31599,16595,15004,11708,5967,5741
396,1,25636000,3,50322,1,16613078,01/03/2022,14.2,29123,15247,13876,9589,4733,4856
397,1,14694000,3,25258,1,9525842,01/03/2022,9.4,18110,9443,8667,6325,3046,3279
398,1,10555000,3,39093,1,6821657,01/03/2022,14.2,31695,16422,15273,11280,5582,5698
399,1,14816000,3,32253,1,9598147,01/03/2022,14.2,95322,48884,46438,32521,16133,16388
400,1,13805000,3,27139,1,8946111,01/03/2022,14.2,9358,5013,4345,2738,1323,1415
401,1,10521000,3,47568,1,6791082,01/03/2022,14.8,9149,4948,4201,2691,1357,1334
402,1,3266000,3,22798,1,2100102,01/03/2022,14.2,9913,5282,4631,3496,1711,1785
403,1,9640000,3,9360,1,6256640,01/03/2022,14.2,36620,18819,17801,10303,4961,5342
404,1,1789000,3,30497,1,1132353,01/03/2022,14.2,5276,2719,2557,1830,893,937
405,1,17396000,3,25867,1,11281533,01/03/2022,14.2,41455,21994,19461,13993,6843,7150
406,1,14434000,3,23968,1,9358132,01/03/2022,16.4,29613,15403,14210,9414,4672,4742
408,1,9520000,3,21770,1,6166230,01/03/2022,15.9,13922,7166,6756,5211,2590,2621
409,1,3347000,3,21210,1,2154340,01/03/2022,14.2,10960,5789,5171,3556,1785,1771
410,1,11082000,3,25867,1,7177433,01/03/2022,12.8,22904,12086,10818,7644,3743,3901
411,1,6821000,3,22762,1,4410888,01/03/2022,14.2,11776,6077,5699,3730,1832,1898
412,1,1555000,3,8625,1,1002125,01/03/2022,14.2,16797,8560,8237,5425,2652,2773
413,1,3082000,3,22798,1,1980502,01/03/2022,14.2,19648,10052,9596,6751,3334,3417
414,1,13485000,3,26464,1,8738786,01/03/2022,24.1,19341,10302,9039,6428,3158,3270
415,1,2671000,3,24181,1,1711969,01/03/2022,15.6,11487,6208,5279,3749,1855,1894
416,1,4370000,3,17502,1,2822998,01/03/2022,14.2,5703,2985,2718,1959,971,988
417,1,1759000,3,20005,1,1123345,01/03/2022,14.2,6644,3435,3209,2305,1130,1175
418,1,3001000,3,14463,1,1936187,01/03/2022,14.2,7491,3982,3509,2583,1266,1317
419,1,1801000,3,11877,1,1158773,01/03/2022,14.2,8481,4360,4121,2849,1391,1458
420,1,20138000,3,33985,1,13055715,01/03/2022,17.6,46996,24240,22756,12187,6012,6175
421,1,2541000,3,20343,1,1631307,01/03/2022,20.3,8445,4468,3977,3005,1505,1500
422,1,5490000,3,21505,1,3546995,01/03/2022,16.1,5612,3027,2585,1851,938,913
423,1,5858000,3,23748,1,3783952,01/03/2022,25,5276,2719,2557,1830,893,937
424,3,163512000,1,236580,3,106046220,01/03/2022,19.4,794789,407239,387550,199480,98049,101431
425,2,40762000,2,56837,2,26438463,01/03/2022,17.1,177719,91525,86194,50219,24680,25539
426,1,17622000,3,26957,1,11427343,01/03/2022,17.1,34955,18206,16749,9854,4805,5049
427,1,1999000,3,21118,1,1278232,01/03/2022,16.3,115264,60166,55098,28758,14392,14366
428,1,14048000,3,23705,1,9107495,01/03/2022,17.1,16795,8697,8098,5436,2628,2808
429,1,5977000,3,22943,1,3862107,01/03/2022,19.8,13390,6831,6559,4033,1966,2067
430,1,7151000,3,23759,1,4624391,01/03/2022,19.8,7953,4224,3729,2375,1195,1180
431,1,6796000,3,18553,1,4398847,01/03/2022,24.5,15512,8121,7391,5093,2493,2600
432,2,54654000,3,44849,2,35480251,01/03/2022,27.9,169028,86790,82238,45879,22689,23190
433,3,147191000,1,150468,3,95523682,01/03/2022,27.7,888797,441181,447616,247410,121384,126026
434,2,66755000,2,71932,2,43318818,01/03/2022,25.8,304942,149380,155562,85665,42398,43267
435,1,22665000,3,51310,1,14680940,01/03/2022,28.3,84519,42292,42227,24955,12440,12515
436,1,16319000,3,21815,1,10585535,01/03/2022,26,30754,15948,14806,10320,5221,5099
437,3,120991000,1,124144,3,78520006,01/03/2022,18.5,845941,437370,408571,227808,112567,115241
438,2,51538000,2,60400,2,33439300,01/03/2022,23.7,136351,71718,64633,38918,19062,19856
439,1,28072000,3,51331,1,18195469,01/03/2022,19.4,86686,44901,41785,27406,13467,13939
440,2,31923000,3,45340,2,20704610,01/03/2022,22.6,58158,30570,27588,17715,8934,8781
441,1,24222000,2,64466,1,15679834,01/03/2022,22.8,24258,12834,11424,7258,3602,3656
442,1,11605000,3,26334,1,7516916,01/03/2022,23.4,24454,12691,11763,7326,3576,3750
443,1,19309000,3,28231,1,12522619,01/03/2022,18.9,310192,159130,151062,94872,46787,48085
444,1,2806000,3,25453,1,1798447,01/03/2022,18.7,14340,7646,6694,4731,2430,2301
445,2,57534000,2,69860,2,37327240,01/03/2022,23.4,15341,8078,7263,4842,2416,2426
446,1,4526000,3,25523,1,2916377,01/03/2022,22.8,8045,4283,3762,2501,1247,1254
447,1,8731000,3,23222,1,5651928,01/03/2022,22.8,6644,3540,3104,2086,1058,1028
448,1,3416000,3,20916,1,2199484,01/03/2022,23.4,16582,8647,7935,5030,2477,2553
449,1,23907000,2,65332,1,15474218,01/03/2022,21.2,30796,15740,15056,9239,4503,4736
450,2,62076000,2,76424,2,40272976,01/03/2022,21.1,77849,40866,36983,21990,10871,11119
451,1,28865000,3,38518,1,18723732,01/03/2022,22,65215,33971,31244,19700,9733,9967
452,3,107909000,1,139667,3,70001183,01/03/2022,18.7,441975,227109,214866,122010,60145,61865
453,3,251828000,1,233572,3,163454628,01/03/2022,22.1,808416,416251,392165,234633,115277,119356
454,2,80242000,1,128549,2,52028751,01/03/2022,21.9,298009,154344,143665,83869,41238,42631
455,1,13566000,3,21815,1,8796085,01/03/2022,23.6,33924,17240,16684,10629,5267,5362
456,1,11240000,3,30697,1,7275303,01/03/2022,21.8,14772,7516,7256,4444,2199,2245
457,1,18169000,3,31827,1,11778023,01/03/2022,20.7,19742,9908,9834,6831,3367,3464
458,1,9850000,3,27167,1,6375333,01/03/2022,21.9,12848,6693,6155,3711,1831,1880
459,1,10194000,3,30807,1,6595293,01/03/2022,20.7,5457,2839,2618,1473,755,718
460,1,6008000,3,26808,1,3878392,01/03/2022,20.6,5926,3043,2883,1700,842,858
461,1,9669000,3,25990,1,6258860,01/03/2022,23.6,17097,8801,8296,5359,2662,2697
462,1,14335000,3,50615,1,9267135,01/03/2022,21.2,28239,14113,14126,8795,4312,4483
463,1,11487000,3,23093,1,7443457,01/03/2022,19.3,16934,8502,8432,5395,2626,2769
464,1,12661000,3,48811,1,8180839,01/03/2022,20.6,11851,5973,5878,3739,1841,1898
465,1,6850000,3,31114,1,4421386,01/03/2022,21.7,25157,12582,12575,8765,4230,4535
466,1,3353000,3,21783,1,2157667,01/03/2022,26.4,6055,3107,2948,1652,803,849
467,1,3115000,3,23142,1,2001608,01/03/2022,21.7,22421,11364,11057,6263,3134,3129
468,1,1990000,3,23178,1,1270322,01/03/2022,19.3,9864,5093,4771,3123,1529,1594
469,1,2961000,3,18578,1,1906072,01/03/2022,20.8,7888,4037,3851,3058,1509,1549
470,1,4498000,3,25400,1,2898300,01/03/2022,20.7,5524,2885,2639,1817,894,923
472,1,2766000,3,20046,1,1777854,01/03/2022,24.2,10328,5288,5040,3690,1794,1896
473,1,959000,3,2794,1,620556,01/03/2022,20.8,4810,2229,2581,1556,759,797
474,2,75802000,1,128531,2,49142769,01/03/2022,22.1,329404,168547,160857,90108,44605,45503
475,3,145255000,1,254802,3,94160948,01/03/2022,21,855563,431621,423942,240318,117646,122672
476,2,29047000,2,65812,2,18814738,01/03/2022,18.9,117253,59414,57839,33098,16300,16798
477,2,59453000,2,61973,2,38582477,01/03/2022,20.6,176685,87738,88947,53884,26504,27380
478,2,59946000,1,118335,2,38846565,01/03/2022,14.9,261137,131158,129979,84004,41439,42565
479,2,35200000,3,47167,2,22832833,01/03/2022,19.9,120926,61958,58968,34805,17098,17707
480,1,23866000,3,31728,1,15481172,01/03/2022,22.7,67604,34141,33463,21101,10330,10771
481,1,11764000,3,24356,1,7622244,01/03/2022,20.2,38886,19733,19153,11641,5731,5910
482,1,13389000,3,23198,1,8679652,01/03/2022,17.5,30324,15540,14784,8298,4088,4210
483,1,23306000,3,35565,1,15113335,01/03/2022,12.7,91029,45722,45307,30379,15003,15376
484,1,22809000,3,27150,1,14798700,01/03/2022,19.7,62301,30877,31424,20494,10127,10367
485,1,2444000,3,21462,1,1567138,01/03/2022,15.4,12987,6460,6527,4296,2156,2140
486,1,12791000,3,27646,1,8286504,01/03/2022,14.6,38113,19225,18888,12385,6138,6247
487,1,2089000,3,22798,1,1335052,01/03/2022,20.9,12372,6340,6032,3845,1851,1994
488,1,9823000,3,22848,1,6362102,01/03/2022,16.9,39474,19169,20305,14904,7336,7568
489,1,11635000,3,27073,1,7535677,01/03/2022,17,30429,15578,14851,9786,4826,4960
490,1,4494000,3,25867,1,2895233,01/03/2022,16.8,13153,6653,6500,4059,2009,2050
491,1,4890000,3,26017,1,3152483,01/03/2022,16.6,11440,5836,5604,4121,2095,2026
492,1,2210000,3,25829,1,1410671,01/03/2022,17.4,4787,2437,2350,1357,684,673
493,2,98529000,1,152390,2,63891460,01/03/2022,25.6,340060,178122,161938,86078,42456,43622
494,2,44652000,3,40817,2,28982983,01/03/2022,26.4,43035,22773,20262,11996,6054,5942
495,1,20747000,3,33055,1,13452495,01/03/2022,27.7,27182,14325,12857,8434,4220,4214
496,1,14912000,3,24532,1,9668268,01/03/2022,26.4,21003,10909,10094,6452,3209,3243
497,1,23212000,3,32240,1,15055560,01/03/2022,27.3,31435,16316,15119,9125,4445,4680
498,1,15564000,3,42662,1,10073938,01/03/2022,26.3,29068,15153,13915,8638,4280,4358
499,1,20526000,3,22288,1,13319612,01/03/2022,26.7,25555,13197,12358,7191,3479,3712
500,1,6508000,3,18967,1,4211233,01/03/2022,26.9,13944,7272,6672,4420,2177,2243
501,1,18896000,3,21815,1,12260585,01/03/2022,27.2,34946,17956,16990,11208,5422,5786
502,1,12086000,3,22982,1,7832918,01/03/2022,26.1,16679,8618,8061,4633,2284,2349
503,2,58242000,2,76337,2,37780963,01/03/2022,22.3,297373,155718,141655,71865,35366,36499
504,3,147753000,1,194921,3,95844529,01/03/2022,20.1,691557,348387,343170,213267,104895,108372
505,2,73184000,2,69266,2,47500334,01/03/2022,21.5,416055,211059,204996,132268,65355,66913
506,1,18670000,3,33003,1,12102497,01/03/2022,19.7,111314,55902,55412,35576,17423,18153
507,2,65466000,2,90616,2,42462284,01/03/2022,22.2,332100,171749,160351,94911,46503,48408
508,2,31707000,3,42826,2,20566724,01/03/2022,24.1,79515,41903,37612,21445,10720,10725
509,2,30471000,3,51580,2,19754570,01/03/2022,21.5,205933,107685,98248,49242,24249,24993
510,1,13273000,3,24700,1,8602750,01/03/2022,20.3,48172,24667,23505,15031,7399,7632
511,1,11622000,3,24188,1,7530112,01/03/2022,19.7,18592,8945,9647,4116,2046,2070
512,1,27882000,3,39075,1,18084225,01/03/2022,22.3,79824,40689,39135,24808,12213,12595
513,1,2651000,3,20105,1,1703045,01/03/2022,19.7,10327,5388,4939,2996,1506,1490
514,1,7343000,3,19689,1,4753261,01/03/2022,19.7,28215,14347,13868,9384,4582,4802
515,1,6738000,3,2511,1,4377189,01/03/2022,23.6,10993,5737,5256,3544,1803,1741
517,1,24689000,3,37160,1,16010690,01/03/2022,15.3,53373,27810,25563,15744,7755,7989
518,2,32814000,2,75060,2,21254040,01/03/2022,16.8,13555,7357,6198,3051,1547,1504
519,1,24874000,3,38230,1,16129870,01/03/2022,13.6,59871,31271,28600,19112,9469,9643
520,2,43475000,2,64177,2,28194573,01/03/2022,15.2,47632,25410,22222,12563,6265,6298
521,1,18498000,3,34927,1,11988773,01/03/2022,16,45587,23716,21871,14000,6913,7087
522,1,12806000,3,23961,1,8299939,01/03/2022,13.8,37704,19683,18021,12453,6131,6322
523,1,13081000,3,17625,1,8485025,01/03/2022,15.3,70224,35655,34569,24421,12033,12388
524,1,3414000,3,22066,1,2197034,01/03/2022,15.3,17978,9382,8596,6248,3105,3143
525,1,1404000,3,23594,1,889006,01/03/2022,15.3,13401,6929,6472,4288,2149,2139
526,1,1340000,3,17132,1,853868,01/03/2022,15.3,30417,15670,14747,9405,4719,4686
527,1,6422000,3,20279,1,4154021,01/03/2022,15.3,28657,14853,13804,9078,4552,4526
528,1,1117000,3,11206,1,714844,01/03/2022,15.3,1583,826,757,480,230,250
529,2,52702000,2,80539,2,34175761,01/03/2022,21.3,139075,74465,64610,36819,18286,18533
530,2,59443000,2,73105,2,38564845,01/03/2022,19.4,120500,65043,55457,29046,14403,14643
531,2,62576000,2,52815,2,40621585,01/03/2022,23.5,101336,54039,47297,24763,12096,12667
532,3,127959000,1,280285,3,82893065,01/03/2022,23.9,405952,215818,190134,89205,43880,45325
533,2,55981000,2,99396,2,36288254,01/03/2022,24.9,212540,111746,100794,51580,25268,26312
534,2,58574000,1,122272,2,37950828,01/03/2022,23.7,180057,96347,83710,45301,22589,22712
535,2,70957000,1,188557,2,45933493,01/03/2022,18.8,443063,237967,205096,110147,54509,55638
536,1,24175000,3,28416,1,15685334,01/03/2022,22.3,33226,17650,15576,10241,5095,5146
537,1,9351000,3,31581,1,6046569,01/03/2022,25,15512,8193,7319,4859,2440,2419
538,2,36825000,3,49054,2,23887196,01/03/2022,21.7,64445,34215,30230,17692,8626,9066
539,2,33744000,3,45391,2,21888209,01/03/2022,25.4,48567,25769,22798,13570,6693,6877
540,1,21187000,3,27496,1,13744054,01/03/2022,14.2,42451,22342,20109,14824,7241,7583
541,1,17894000,3,26251,1,11604849,01/03/2022,23.6,41588,21739,19849,12522,6161,6361
543,1,23101000,3,44944,1,14970706,01/03/2022,23.7,55452,29697,25755,14940,7380,7560
544,1,1748000,3,21553,1,1114647,01/03/2022,23.9,6076,3180,2896,1703,844,859
545,2,40665000,2,56994,2,26375256,01/03/2022,23.7,64692,34002,30690,19678,9778,9900
546,1,1717000,3,20965,1,1095085,01/03/2022,23.9,22760,12125,10635,6420,3229,3191
547,1,14271000,3,33954,1,9242196,01/03/2022,24.3,25608,13480,12128,7723,3870,3853
548,1,10641000,3,51397,1,6865253,01/03/2022,21.7,15733,8506,7227,4079,2054,2025
549,1,6820000,3,23156,1,4409844,01/03/2022,19.4,41785,22480,19305,10854,5445,5409
550,1,9515000,3,35997,1,6148753,01/03/2022,23.6,13225,6946,6279,3476,1669,1807
551,1,14386000,3,32931,1,9317969,01/03/2022,18.4,28655,15243,13412,8764,4302,4462
552,1,7025000,3,35498,1,4530752,01/03/2022,23.8,17727,9423,8304,4199,2068,2131
553,1,12896000,2,91853,1,8290547,01/03/2022,25,8969,4883,4086,2821,1444,1377
554,1,10876000,3,24228,1,7045172,01/03/2022,26.3,16758,8967,7791,4993,2542,2451
555,2,32281000,3,45643,2,20937007,01/03/2022,23.7,47035,25085,21950,12872,6289,6583
556,1,17443000,3,26167,1,11311783,01/03/2022,23.7,55720,29557,26163,14521,7123,7398
557,1,20008000,3,29090,1,12976110,01/03/2022,23.2,46909,24866,22043,15156,7483,7673
558,1,12536000,3,31483,1,8116917,01/03/2022,23.2,33986,17827,16159,9043,4421,4622
559,1,14322000,3,22626,1,9286674,01/03/2022,19.4,34847,18666,16181,8943,4380,4563
560,1,13265000,3,34382,1,8587868,01/03/2022,24.4,14304,7545,6759,4455,2182,2273
561,1,7974000,3,22159,1,5160941,01/03/2022,23.8,20797,10995,9802,4991,2418,2573
562,1,16444000,3,22626,1,10665974,01/03/2022,23.9,30232,15727,14505,8913,4281,4632
563,1,23652000,2,59800,1,15314000,01/03/2022,24,20165,10621,9544,5395,2701,2694
564,1,2420000,3,19974,1,1553026,01/03/2022,23.7,20380,10692,9688,6259,3127,3132
565,1,9719000,3,21900,1,6295450,01/03/2022,15.1,21640,11976,9664,7433,3885,3548
566,1,19577000,3,30694,1,12694356,01/03/2022,15.7,33402,17876,15526,9753,4761,4992
567,1,22635000,3,42357,1,14670393,01/03/2022,21.9,26236,13620,12616,8067,3962,4105
568,1,3441000,3,30114,1,2206536,01/03/2022,25.4,4405,2358,2047,1451,735,716
569,1,3674000,3,25638,1,2362462,01/03/2022,24.1,13716,7109,6607,3981,1920,2061
570,1,11491000,3,23617,1,7445533,01/03/2022,24.4,5653,2987,2666,1709,826,883
571,1,9308000,3,27968,1,6022232,01/03/2022,19.8,21318,11472,9846,5688,2873,2815
572,1,10076000,3,24494,1,6524906,01/03/2022,24.4,14582,7621,6961,4539,2262,2277
573,1,1779000,3,29351,1,1126999,01/03/2022,24.6,6219,3311,2908,1883,941,942
574,1,9117000,3,32451,1,5893599,01/03/2022,25.5,31856,17018,14838,8563,4318,4245
575,1,14485000,3,23781,1,9391469,01/03/2022,19.4,35893,18883,17010,11399,5600,5799
576,1,15502000,3,25738,1,10050562,01/03/2022,19.8,19272,10328,8944,5163,2534,2629
577,1,15067000,3,26334,1,9767216,01/03/2022,12.6,16364,8711,7653,5250,2654,2596
578,1,10360000,3,24208,1,6709792,01/03/2022,23.9,2820,1449,1371,720,341,379
579,1,2158000,3,23713,1,1378987,01/03/2022,25.7,4654,2510,2144,1296,630,666
580,1,1475000,3,22754,1,935996,01/03/2022,12.6,21585,11243,10342,6456,3197,3259
581,1,1508000,3,25294,1,954906,01/03/2022,24.4,6888,3543,3345,1840,922,918
582,1,1813000,3,23996,1,1154454,01/03/2022,24.6,21391,11404,9987,5619,2742,2877
583,1,1424000,3,22823,1,902777,01/03/2022,23.9,9668,5030,4638,2384,1141,1243
584,1,15885000,3,23494,1,10301756,01/03/2022,25.5,13995,7311,6684,4212,2070,2142
585,1,4329000,3,23466,1,2790384,01/03/2022,23.7,6838,3583,3255,1791,891,900
586,1,1370000,3,23530,1,866970,01/03/2022,24.6,5681,3058,2623,1606,823,783
587,1,7867000,3,23624,1,5089926,01/03/2022,12.6,13966,7679,6287,3739,1859,1880
588,1,11571000,3,15941,1,7505209,01/03/2022,24.9,28076,14773,13303,7550,3752,3798
589,1,5705000,3,23080,1,3685170,01/03/2022,12.9,34039,18008,16031,8858,4334,4524
590,1,1670000,3,19171,1,1066329,01/03/2022,19.4,15807,8231,7576,5949,2955,2994
591,1,1156000,3,13076,1,738324,01/03/2022,23.7,10581,5508,5073,2907,1418,1489
592,1,3416000,3,22503,1,2197897,01/03/2022,17.1,9554,4935,4619,2707,1302,1405
593,1,12791000,3,46948,1,8267202,01/03/2022,23.2,9988,5342,4646,2237,1127,1110
594,1,2135000,3,13593,1,1374157,01/03/2022,23.2,7578,3984,3594,2088,1031,1057
595,1,2171000,3,29765,1,1381385,01/03/2022,19,8005,4106,3899,2599,1296,1303
596,1,2565000,3,21045,1,1646205,01/03/2022,24.9,24085,12288,11797,7909,3780,4129
597,1,3531000,3,21771,1,2273379,01/03/2022,24.6,7455,4054,3401,2223,1145,1078
598,1,965000,3,8432,1,618818,01/03/2022,24.6,17919,9538,8381,4548,2298,2250
599,1,5003000,3,24067,1,3227883,01/03/2022,23.7,15305,8066,7239,4706,2332,2374
600,3,137916000,1,254618,3,89390782,01/03/2022,27,921771,479309,442462,222551,109790,112761
601,1,12950000,3,23265,1,8394235,01/03/2022,24.7,26081,13338,12743,7626,3791,3835
602,1,28570000,3,22691,1,18547809,01/03/2022,27.2,56494,29131,27363,17460,8617,8843
603,1,16141000,3,26808,1,10464842,01/03/2022,25.1,52593,26982,25611,16883,8307,8576
604,1,5845000,3,30654,1,3768596,01/03/2022,26.2,41965,21110,20855,11192,5453,5739
605,1,8303000,3,28232,1,5368718,01/03/2022,26,26175,13553,12622,8885,4301,4584
606,1,11223000,3,24543,1,7270407,01/03/2022,25.9,35183,17868,17315,10650,5230,5420
607,1,8957000,3,24097,1,5797953,01/03/2022,24.9,56409,28489,27920,16919,8292,8627
608,1,8397000,3,11279,1,5446771,01/03/2022,26.8,139753,70456,69297,45077,22298,22779
609,1,6311000,3,22705,1,4079445,01/03/2022,25.8,17841,9042,8799,5372,2677,2695
610,1,7338000,3,19166,1,4750534,01/03/2022,26.8,28461,14574,13887,9148,4533,4615
611,2,36210000,2,59332,2,23477168,01/03/2022,17.6,143281,73905,69376,47529,23519,24010
612,2,41065000,2,96539,2,26595711,01/03/2022,17,138444,72335,66109,38201,18773,19428
613,1,11610000,3,24227,1,7522273,01/03/2022,17.2,22295,11690,10605,8176,4115,4061
614,1,13183000,3,47657,1,8521293,01/03/2022,16,25068,12776,12292,8673,4237,4436
615,1,2406000,3,25400,1,1538500,01/03/2022,16.8,15291,7886,7405,5051,2477,2574
616,1,5135000,3,23372,1,3314378,01/03/2022,16.3,38193,19467,18726,13775,6896,6879
617,1,9773000,3,25997,1,6326453,01/03/2022,17.6,46132,23831,22301,13972,6871,7101
618,1,1804000,3,21348,1,1151252,01/03/2022,21.4,13641,7027,6614,4307,2133,2174
1,2,82640000,1,164810,2,53551190,01/02/2022,17,863893,444725,419168,260350,128225,132125
2,1,13824000,3,26572,1,8959028,01/02/2022,16.5,31963,16433,15530,11390,5609,5781
3,1,8222000,3,23570,1,5320730,01/02/2022,14.9,63805,32406,31399,23397,11652,11745
4,1,7887000,3,22798,1,5103752,01/02/2022,16.5,21049,10874,10175,7097,3529,3568
5,1,3791000,3,24827,1,2439323,01/02/2022,14.7,32035,16367,15668,10989,5374,5615
6,3,166130000,1,242434,3,107742066,01/02/2022,16.5,854186,425977,428209,227917,112151,115766
7,3,334145000,1,493399,3,216700851,01/02/2022,15.8,1810645,899293,911352,503963,246971,256992
8,2,67173000,2,82085,2,43580365,01/02/2022,13.7,330652,167339,163313,86895,42903,43992
9,1,27433000,3,25041,1,17806409,01/02/2022,13.6,81059,40420,40639,23492,11470,12022
10,1,28604000,3,45857,1,18546743,01/02/2022,16,100660,49935,50725,28067,13772,14295
11,1,16176000,3,21541,1,10492859,01/02/2022,15.8,19081,9476,9605,5934,2909,3025
12,2,60465000,1,106202,2,39196048,01/02/2022,22,250141,126245,123896,65670,32312,33358
13,2,45909000,2,77915,2,29762935,01/02/2022,17.7,136285,66083,70202,42780,21001,21779
14,2,56506000,1,111813,2,36617087,01/02/2022,21.4,202694,98608,104086,64935,31858,33077
15,1,19015000,3,31888,1,12327862,01/02/2022,17.9,43805,22160,21645,13050,6507,6543
16,1,21206000,2,69849,1,13714051,01/02/2022,19,16311,8010,8301,4984,2435,2549
17,1,7603000,3,34038,1,4907912,01/02/2022,17.5,14357,6822,7535,3854,1925,1929
18,1,2664000,3,25250,1,1706350,01/02/2022,14.8,13596,6842,6754,4196,2086,2110
19,1,7942000,3,33183,1,5129117,01/02/2022,16.8,13596,6842,6754,4196,2086,2110
20,1,2506000,3,25087,1,1603813,01/02/2022,18.2,7185,3509,3676,2099,1015,1084
21,2,35724000,2,59248,2,23161352,01/02/2022,25.6,191238,97313,93925,52600,25862,26738
22,2,36249000,2,62982,2,23498868,01/02/2022,25.9,249623,130524,119099,66498,32635,33863
23,1,21825000,3,26321,1,14159929,01/02/2022,26.2,31375,16375,15000,10682,5317,5365
24,1,14706000,3,30259,1,9528641,01/02/2022,24.9,35799,18291,17508,11962,5883,6079
25,1,9599000,3,26105,1,6213245,01/02/2022,25.4,15949,8217,7732,4538,2234,2304
26,2,71605000,2,77928,2,46465322,01/02/2022,27.8,217550,113613,103937,65123,32048,33075
27,2,39175000,3,41119,2,25422631,01/02/2022,15,183509,96930,86579,60413,30246,30167
28,2,39707000,2,66294,2,25743256,01/02/2022,18.1,113479,60064,53415,36594,18199,18395
29,2,85356000,2,86311,2,55395089,01/02/2022,24.2,578830,303756,275074,166456,82025,84431
30,2,30279000,3,31271,2,19650079,01/02/2022,25.9,51797,27093,24704,17614,8812,8802
31,2,50121000,1,113603,2,32465047,01/02/2022,22.9,38087,20017,18070,11916,5833,6083
32,1,11696000,3,21670,1,7580730,01/02/2022,30.3,32109,16780,15329,10495,5074,5421
33,1,19892000,3,21929,1,12907871,01/02/2022,25.4,21727,11415,10312,7786,3890,3896
34,1,14465000,3,26705,1,9375545,01/02/2022,22.9,49201,25651,23550,16539,8102,8437
35,1,19259000,3,37430,1,12480920,01/02/2022,22.9,37546,19668,17878,11791,5836,5955
36,1,20398000,2,74753,1,13183947,01/02/2022,17.3,47688,25247,22441,17870,8920,8950
37,1,4192000,3,22660,1,2702140,01/02/2022,25.6,55931,28786,27145,18430,9082,9348
38,1,10191000,3,25594,1,6598556,01/02/2022,22.2,29018,15064,13954,10291,5191,5100
39,1,8560000,3,34777,1,5529223,01/02/2022,23.4,18219,9592,8627,5806,2838,2968
40,1,12017000,3,26241,1,7784809,01/02/2022,23.8,15244,8058,7186,4848,2429,2419
41,1,4699000,3,21378,1,3032972,01/02/2022,28.3,25366,13345,12021,7752,3823,3929
42,1,14078000,3,24198,1,9126502,01/02/2022,27.5,19271,9996,9275,6517,3095,3422
43,1,3568000,3,20134,1,2299066,01/02/2022,27.2,7662,4073,3589,2321,1153,1168
45,3,232669000,1,234889,3,150999961,01/02/2022,8.5,1501551,750157,751394,459910,225614,234296
46,2,83263000,1,166942,2,53954008,01/02/2022,11.6,925762,474776,450986,250961,123448,127513
47,1,25516000,3,49733,1,16535667,01/02/2022,14.1,128548,65838,62710,37721,18411,19310
48,1,18893000,3,38813,1,12241637,01/02/2022,10.2,135586,69677,65909,41627,20458,21169
49,1,25068000,2,55206,1,16238994,01/02/2022,12.9,113843,59214,54629,34117,16974,17143
50,1,4087000,3,27266,1,2629284,01/02/2022,16.3,23140,11693,11447,7155,3499,3656
51,1,7764000,3,23265,1,5023335,01/02/2022,13.2,35087,17902,17185,11563,5663,5900
52,1,10407000,3,32737,1,6731813,01/02/2022,12.6,42019,21548,20471,12599,6234,6365
53,1,7959000,3,44111,1,5129239,01/02/2022,12.3,22066,11231,10835,6719,3420,3299
54,1,7864000,3,35681,1,5075919,01/02/2022,5.4,17410,9121,8289,6393,3204,3189
55,1,1818000,3,21585,1,1160115,01/02/2022,25.6,22568,11549,11019,7200,3540,3660
56,1,4655000,3,22275,1,3003475,01/02/2022,6.7,15054,7516,7538,5557,2768,2789
57,1,2511000,2,70754,1,1561396,01/02/2022,9.2,8253,4210,4043,2801,1419,1382
58,1,3951000,3,33560,1,2534590,01/02/2022,7.2,7834,4065,3769,2439,1200,1239
59,1,1764000,3,30840,1,1115760,01/02/2022,2.8,14755,7617,7138,4907,2427,2480
60,1,8864000,3,30666,1,5730934,01/02/2022,8.5,62038,31762,30276,19262,9511,9751
61,2,83678000,1,114445,2,54276255,01/02/2022,18.1,690193,353744,336449,203574,99881,103693
62,3,109285000,1,167233,3,70868017,01/02/2022,13.8,864431,434753,429678,267728,131619,136109
63,2,32278000,3,49340,2,20931360,01/02/2022,15.2,237169,119538,117631,71348,35023,36325
64,2,39420000,2,79709,2,25543291,01/02/2022,14,173959,86825,87134,55826,27459,28367
65,1,7514000,3,22604,1,4861496,01/02/2022,12.5,39058,19755,19303,11201,5479,5722
66,3,103166000,1,180812,3,66877088,01/02/2022,16.5,59762,30506,29256,20025,9931,10094
67,1,12562000,3,35198,1,8130102,01/02/2022,16.3,49490,25496,23994,16916,8460,8456
68,1,23462000,3,51214,1,15199086,01/02/2022,12.6,160225,79799,80426,53549,26489,27060
69,1,13837000,3,15928,1,8978122,01/02/2022,12.8,114010,56192,57818,38156,18905,19251
70,1,21867000,3,38594,1,14174956,01/02/2022,15.8,75242,37695,37547,23792,11778,12014
71,1,9953000,3,23265,1,6446185,01/02/2022,12.4,59196,29915,29281,18125,8949,9176
72,1,12554000,3,26488,1,8133612,01/02/2022,16.2,32704,16713,15991,11320,5572,5748
73,1,4912000,3,22131,1,3170669,01/02/2022,12.5,23413,11884,11529,7157,3552,3605
74,1,7605000,3,22525,1,4920725,01/02/2022,13.3,38992,19602,19390,13022,6299,6723
75,1,1490000,3,17283,1,951217,01/02/2022,14.9,27314,13703,13611,9005,4397,4608
76,2,46022000,2,63136,2,29851164,01/02/2022,25.5,146965,75962,71003,46271,22786,23485
77,1,25921000,3,42122,1,16806528,01/02/2022,28.4,88337,44762,43575,34686,17254,17432
78,2,35861000,2,59508,2,23250142,01/02/2022,26.4,159853,80569,79284,57402,28064,29338
79,1,2322000,3,21591,1,1487709,01/02/2022,25.5,9746,4912,4834,3336,1602,1734
80,1,1953000,3,23929,1,1245521,01/02/2022,26.7,15368,7632,7736,5699,2779,2920
81,1,1028000,3,8697,1,659503,01/02/2022,23.8,147496,76348,71148,49524,24280,25244
82,1,915000,3,23851,1,570899,01/02/2022,25.3,14892,7420,7472,5365,2615,2750
83,1,6122000,3,24985,1,3954315,01/02/2022,13.3,34798,17459,17339,10865,5211,5654
84,2,34322000,1,177455,2,22131845,01/02/2022,16,432205,227255,204950,86717,42372,44345
85,2,36086000,1,159656,2,23296244,01/02/2022,16.9,759003,398068,360935,168014,83097,84917
86,2,82537000,1,293789,2,53355261,01/02/2022,17.3,1173351,609477,563874,261635,129105,132530
87,1,24400000,2,54482,1,15805518,01/02/2022,17.5,414470,219003,195467,75588,37198,38390
88,1,15187000,2,54864,1,9816686,01/02/2022,14,186693,97615,89078,46165,22603,23562
89,3,139713000,1,338734,3,90474716,01/02/2022,16.9,1835486,947835,887651,451632,222341,229291
90,2,48138000,2,103243,2,31186457,01/02/2022,17.2,614447,325337,289110,113945,55951,57994
91,1,22591000,2,80386,1,14603764,01/02/2022,16.7,434153,232032,202121,62030,30612,31418
92,2,48178000,1,112408,2,31203292,01/02/2022,15,323771,167274,156497,83659,40990,42669
93,2,39225000,2,73639,2,25422611,01/02/2022,15,404695,212343,192352,85496,42058,43438
94,1,22228000,1,144456,1,14303744,01/02/2022,16.7,443704,233586,210118,95713,47173,48540
95,2,54915000,1,253290,2,35441460,01/02/2022,15.7,545884,284933,260951,101794,50260,51534
96,1,14874000,2,56338,1,9611762,01/02/2022,15,429481,220393,209088,105785,52018,53767
97,1,8379000,3,45675,1,5400675,01/02/2022,11.2,246428,128767,117661,58169,28791,29378
98,1,9893000,3,27343,1,6403107,01/02/2022,11.2,599935,314284,285651,130174,64060,66114
99,3,104559000,1,154228,3,67809122,01/02/2022,14.2,616068,317266,298802,191866,94056,97810
100,2,60545000,2,71942,2,39282308,01/02/2022,12.5,301742,154079,147663,97495,48007,49488
101,1,8262000,3,18458,1,5351842,01/02/2022,15.2,96243,49040,47203,29383,14345,15038
102,1,15185000,3,45041,1,9825209,01/02/2022,15.3,30063,15334,14729,10450,5151,5299
103,1,1328000,2,91718,1,771482,01/02/2022,22.4,3222,1654,1568,1247,637,610
104,1,10896000,2,69597,1,7012803,01/02/2022,13.4,17967,9205,8762,6003,2945,3058
105,1,2089000,3,20343,1,1337507,01/02/2022,12.9,11943,6311,5632,3854,1993,1861
106,1,1599000,2,93383,1,945967,01/02/2022,15.6,12850,6538,6312,4678,2267,2411
107,2,30510000,2,98599,2,19732901,01/02/2022,7.4,26678,13733,12945,10032,4897,5135
108,3,143982000,1,235397,3,93352903,01/02/2022,11.8,223876,119352,104524,50306,24928,25378
109,2,52296000,1,166378,2,33826022,01/02/2022,13.9,515353,266081,249272,126007,61695,64312
110,2,82007000,1,310183,2,52994367,01/02/2022,14.3,776220,402522,373698,193769,95439,98330
111,2,52835000,2,85756,2,34256994,01/02/2022,14.1,84298,43745,40553,23019,11356,11663
112,2,40840000,2,54337,2,26491663,01/02/2022,13.1,30929,15848,15081,8319,4034,4285
113,1,26430000,1,112051,1,17067449,01/02/2022,14.1,293245,152241,141004,70657,34731,35926
114,2,48474000,1,231941,2,31276159,01/02/2022,13.5,658907,338453,320454,150053,73914,76139
115,1,21041000,3,18728,1,13657922,01/02/2022,13.5,117995,60165,57830,29983,14851,15132
116,3,142546000,1,286208,3,92368692,01/02/2022,11.6,1643623,845932,797691,437489,216020,221469
117,2,62658000,1,150332,2,40577368,01/02/2022,17.1,368585,190133,178452,107535,52900,54635
118,2,38926000,2,59286,2,25242614,01/02/2022,7.5,174704,91497,83207,54449,28355,26094
119,1,17059000,3,41933,1,11046417,01/02/2022,5.1,2931,1520,1411,975,512,463
120,2,47196000,2,99175,2,30578225,01/02/2022,8.5,35491,18986,16505,7987,3993,3994
121,2,53781000,1,141662,2,34815988,01/02/2022,14.1,703215,359601,343614,230612,113552,117060
122,2,51173000,1,163040,2,33099410,01/02/2022,16.2,18226,9300,8926,5308,2603,2705
123,2,43061000,2,56460,2,27933190,01/02/2022,14.8,1072676,556998,515678,265425,131078,134347
124,1,18615000,3,18434,1,12081316,01/02/2022,20.4,14038,7254,6784,3763,1910,1853
125,2,60277000,2,73527,2,39106523,01/02/2022,7.5,174704,91497,83207,54449,28355,26094
126,2,44364000,3,32453,2,28804147,01/02/2022,12,7077,3593,3484,1748,893,855
127,2,31525000,3,50873,2,20440377,01/02/2022,12.7,53362,27304,26058,15169,7515,7654
128,1,14748000,3,17919,1,9568281,01/02/2022,3.7,24612,12254,12358,7339,3541,3798
129,2,39350000,1,165480,2,25412020,01/02/2022,14.8,10873,5623,5250,3757,1878,1879
130,2,48016000,2,55690,2,31154710,01/02/2022,11.4,23219,12339,10880,6425,3186,3239
131,1,20568000,3,34188,1,13335012,01/02/2022,15.3,12671,6512,6159,3454,1710,1744
132,1,17778000,3,31144,1,11524556,01/02/2022,10.5,30967,16277,14690,10756,5327,5429
133,2,33905000,3,51806,2,21986444,01/02/2022,16.4,323545,166328,157217,93932,46757,47175
134,1,5657000,3,17982,1,3659068,01/02/2022,21.7,19326,10155,9171,6252,3129,3123
135,1,18987000,3,32688,1,12308862,01/02/2022,7.5,33716,17686,16030,9317,4624,4693
136,1,10570000,3,47930,1,6822570,01/02/2022,12.3,40279,20716,19563,10282,5078,5204
137,1,3561000,3,20355,1,2294295,01/02/2022,14.2,29068,14916,14152,8580,4220,4360
138,1,24493000,2,54600,1,15865850,01/02/2022,15.8,12752,6694,6058,3471,1768,1703
139,1,4115000,3,46868,1,2627882,01/02/2022,12.8,33166,16973,16193,9497,4707,4790
140,1,5897000,3,9494,1,3823556,01/02/2022,13.5,52828,27143,25685,16500,8128,8372
141,1,26023000,3,23864,1,16891086,01/02/2022,13.7,32738,16941,15797,9059,4431,4628
142,1,9157000,3,24127,1,5927923,01/02/2022,14.2,30203,15792,14411,7568,3777,3791
143,1,25600000,3,34433,1,16605567,01/02/2022,13.5,11760,6069,5691,3432,1700,1732
144,1,10307000,3,17854,1,6681696,01/02/2022,14.8,72525,37076,35449,22128,10944,11184
145,1,6992000,3,25250,1,4519550,01/02/2022,5.1,18580,9729,8851,5724,2801,2923
146,1,16837000,3,27791,1,10916259,01/02/2022,16.2,24575,12798,11777,7126,3453,3673
147,1,1179000,3,19888,1,746462,01/02/2022,14.1,44731,22925,21806,13335,6514,6821
148,1,7193000,3,51350,1,4624100,01/02/2022,13.4,658907,338453,320454,150053,73914,76139
149,1,11391000,3,26930,1,7377220,01/02/2022,14.7,10336,5387,4949,3449,1664,1785
150,1,9562000,3,20011,1,6195289,01/02/2022,12.4,4656,2421,2235,1533,751,782
151,1,6248000,3,25294,1,4035906,01/02/2022,16.4,9598,5002,4596,2910,1467,1443
152,1,8777000,3,17250,1,5687800,01/02/2022,13.5,15171,7853,7318,4470,2251,2219
153,1,5640000,3,23403,1,3642597,01/02/2022,14.2,10792,5577,5215,3492,1713,1779
154,1,1946000,3,3076,1,1261824,01/02/2022,13.5,37442,19141,18301,12089,5963,6126
155,1,3385000,3,25250,1,2175000,01/02/2022,7.5,17736,9182,8554,5577,2775,2802
156,1,7222000,3,8820,1,4685480,01/02/2022,16.2,386290,199249,187041,112223,55337,56886
157,1,7506000,3,28122,1,4850778,01/02/2022,16.2,9925,5218,4707,2833,1403,1430
158,1,7174000,3,23467,1,4639633,01/02/2022,20.4,6944,3666,3278,2341,1149,1192
159,1,6684000,3,17180,1,4327420,01/02/2022,11.6,88734,45471,43263,28316,14166,14150
160,1,6885000,3,18416,1,4456834,01/02/2022,8.5,6449,3346,3103,1687,833,854
161,1,5287000,3,16158,1,3420392,01/02/2022,11.4,10735,5576,5159,3010,1518,1492
162,1,2100000,3,18873,1,1346127,01/02/2022,8.5,10810,5614,5196,2941,1451,1490
165,3,145784000,1,213617,3,94545983,01/02/2022,19.1,1579803,804212,775591,594938,292494,302444
166,2,64389000,2,60932,2,41791918,01/02/2022,14.5,378143,194849,183294,128863,62806,66057
167,2,60848000,2,62843,2,39488357,01/02/2022,18.3,452090,230346,221744,162764,80177,82587
168,1,18548000,3,35093,1,12021107,01/02/2022,17.7,69371,35473,33898,25304,12303,13001
169,1,26136000,3,46195,1,16942205,01/02/2022,17.3,79772,40908,38864,30907,15312,15595
170,1,20488000,3,36985,1,13280215,01/02/2022,17.7,56597,29703,26894,19146,9514,9632
171,1,20149000,3,30749,1,13066101,01/02/2022,15.2,72663,38036,34627,27395,13712,13683
172,2,38744000,2,76099,2,25107501,01/02/2022,17.6,160682,83178,77504,52342,25860,26482
173,1,24506000,3,33829,1,15895071,01/02/2022,16.4,83352,42766,40586,32937,16375,16562
174,1,27709000,3,31741,1,17979109,01/02/2022,15.1,67101,35567,31534,27008,13393,13615
175,1,15176000,3,28163,1,9836237,01/02/2022,17.8,43249,22352,20897,17065,8284,8781
176,1,20145000,3,38019,1,13056231,01/02/2022,15.3,51894,27702,24192,20579,10113,10466
177,1,19462000,3,46878,1,12603422,01/02/2022,17.2,70068,36526,33542,21044,10402,10642
178,1,16892000,3,25438,1,10954362,01/02/2022,17.4,52156,27081,25075,17108,8394,8714
179,1,3490000,3,24647,1,2243853,01/02/2022,21.6,41910,21741,20169,12631,6146,6485
180,1,18398000,3,47036,1,11911664,01/02/2022,15.9,43998,23109,20889,17575,8775,8800
181,1,4259000,3,24905,1,2743445,01/02/2022,19.2,24757,12827,11930,9816,4898,4918
182,1,3047000,3,19350,1,1961200,01/02/2022,17.1,21756,11234,10522,8659,4317,4342
183,1,6860000,3,8820,1,4450180,01/02/2022,15.9,28109,14419,13690,10548,5187,5361
184,1,5573000,3,23265,1,3599185,01/02/2022,18.4,15305,7996,7309,5899,2872,3027
185,1,21379000,3,35302,1,13861048,01/02/2022,15.7,72452,38019,34433,23628,11618,12010
186,1,17021000,3,24749,1,11038901,01/02/2022,17.3,35401,18444,16957,12235,5945,6290
187,1,20955000,3,36481,1,13584269,01/02/2022,15.9,27593,14289,13304,10803,5260,5543
188,1,15422000,3,21929,1,10002371,01/02/2022,16.7,31264,16171,15093,9806,4840,4966
189,1,14795000,3,35613,1,9581137,01/02/2022,14.7,24228,12861,11367,9383,4674,4709
190,1,16630000,3,25049,1,10784451,01/02/2022,12.4,32831,17049,15782,13856,6706,7150
191,1,2439000,3,22798,1,1562552,01/02/2022,18.2,16092,8507,7585,6837,3451,3386
192,1,6803000,3,27447,1,4394503,01/02/2022,16.8,8011,4268,3743,3134,1562,1572
193,1,12555000,3,23363,1,8137387,01/02/2022,19.1,29002,14796,14206,11206,5550,5656
194,1,2215000,3,26241,1,1413509,01/02/2022,14.1,7946,4172,3774,3293,1607,1686
195,1,8905000,3,8899,1,5779351,01/02/2022,18.6,28260,14728,13532,11002,5473,5529
196,1,5090000,3,4418,1,3304082,01/02/2022,16.6,25845,13471,12374,9370,4627,4743
197,3,122116000,1,182520,3,79192880,01/02/2022,26.7,658609,345979,312630,183298,90145,93153
198,2,45818000,2,55067,2,29726633,01/02/2022,22,225728,119129,106599,71494,35347,36147
199,2,29428000,3,40936,2,19087264,01/02/2022,29.7,70760,36613,34147,21788,10705,11083
200,2,34028000,2,76096,2,22042104,01/02/2022,25.6,132854,69610,63244,41183,20301,20882
201,1,14532000,2,54749,1,9391051,01/02/2022,21.7,50399,26542,23857,14000,6918,7082
202,1,2350000,3,25515,1,1501985,01/02/2022,23.9,27944,14419,13525,9490,4664,4826
203,1,4755000,3,26626,1,3064124,01/02/2022,15.8,22534,11802,10732,7926,3939,3987
204,1,12326000,3,25735,1,7986165,01/02/2022,27.1,25148,13436,11712,8928,4476,4452
205,1,20330000,3,25638,1,13188862,01/02/2022,19.8,33783,18241,15542,12201,6089,6112
206,1,27165000,3,27914,1,17629336,01/02/2022,27.7,25850,13268,12582,8390,4048,4342
208,1,26006000,3,32534,1,16871366,01/02/2022,19,27607,14605,13002,9883,5002,4881
209,1,9215000,3,25638,1,5964112,01/02/2022,25.7,13866,7187,6679,4383,2099,2284
210,1,6056000,3,25294,1,3911106,01/02/2022,26.9,23363,12127,11236,7776,3818,3958
211,1,13802000,3,31124,1,8940176,01/02/2022,25.8,18224,9500,8724,7072,3514,3558
212,1,12026000,3,24076,1,7792824,01/02/2022,27.4,16447,8464,7983,4843,2381,2462
213,1,5296000,3,18610,1,3423790,01/02/2022,22.5,17550,9283,8267,5700,2861,2839
214,2,60444000,1,150497,2,39138103,01/02/2022,15,297848,156299,141549,74787,37046,37741
215,1,24164000,3,22047,1,15684553,01/02/2022,16,29390,15521,13869,7939,3942,3997
216,1,28869000,2,65375,1,18699475,01/02/2022,15.9,37608,20094,17514,11115,5490,5625
217,2,32426000,2,65015,2,21011885,01/02/2022,15.3,106163,56161,50002,30752,15034,15718
218,1,12089000,3,23570,1,7834280,01/02/2022,13.7,11149,5894,5255,2996,1479,1517
219,2,31949000,3,49281,2,20717569,01/02/2022,12.1,60265,30945,29320,18808,9224,9584
220,1,18039000,3,30422,1,11694928,01/02/2022,17,17718,9411,8307,4913,2492,2421
221,1,15803000,3,38701,1,10233249,01/02/2022,15.7,36618,19077,17541,10530,5273,5257
222,1,10069000,3,21677,1,6523173,01/02/2022,16.7,9853,5224,4629,2757,1390,1367
223,1,2443000,3,25508,1,1562442,01/02/2022,16,27713,14561,13152,7736,3885,3851
224,1,5899000,3,23401,1,3810949,01/02/2022,15.2,32276,17014,15262,9457,4578,4879
225,1,7862000,3,23334,1,5086966,01/02/2022,16.7,14689,7582,7107,4123,2033,2090
226,2,34523000,3,44705,2,22395245,01/02/2022,21.7,44311,23331,20980,13756,6771,6985
227,1,3752000,3,24803,1,2413997,01/02/2022,18,14732,7791,6941,4911,2433,2478
228,1,10225000,3,23655,1,6622595,01/02/2022,15.4,20530,10890,9640,6356,3180,3176
229,1,10756000,3,21585,1,6969815,01/02/2022,18.5,16368,8558,7810,4728,2323,2405
230,1,7491000,3,21277,1,4847873,01/02/2022,11.4,6213,3216,2997,1786,871,915
231,1,9667000,3,21171,1,6262379,01/02/2022,12.1,28792,15288,13504,8327,4111,4216
233,1,4303000,3,4847,1,2792103,01/02/2022,16.6,8657,4501,4156,2464,1200,1264
234,2,54842000,2,101138,2,35546162,01/02/2022,21.2,224166,112147,112019,65088,31954,33134
235,1,23217000,2,63712,1,15027338,01/02/2022,15.9,111569,57370,54199,36412,17892,18520
236,1,21012000,3,32072,1,13625728,01/02/2022,18.5,38780,20122,18658,13025,6461,6564
237,3,123353000,1,316212,3,79863238,01/02/2022,18.4,1385621,718628,666993,333198,164217,168981
238,2,84753000,1,235646,2,54853804,01/02/2022,17.3,1257547,645398,612149,321993,158559,163434
239,1,17700000,3,30999,1,11474001,01/02/2022,18.5,37871,19554,18317,11359,5732,5627
240,2,69370000,1,188355,2,44902145,01/02/2022,20.3,650123,329365,320758,200033,98558,101475
241,2,33341000,2,66136,2,21605514,01/02/2022,18.8,111975,57735,54240,31481,15460,16021
242,1,11971000,3,21619,1,7759531,01/02/2022,18.5,98842,50427,48415,30938,15263,15675
243,2,52420000,1,176672,2,33896328,01/02/2022,17.3,44103,22420,21683,15768,7755,8013
244,1,9178000,3,27467,1,5938233,01/02/2022,14.8,53539,27205,26334,18000,8916,9084
245,1,9458000,3,25491,1,6122209,01/02/2022,27.2,18787,9476,9311,6502,3270,3232
246,1,14484000,3,32896,1,9381704,01/02/2022,18.5,59648,30609,29039,19344,9536,9808
247,2,48078000,2,96732,2,31153968,01/02/2022,18.8,30471,15635,14836,9610,4654,4956
248,1,3248000,3,25300,1,2085900,01/02/2022,18.1,20286,10307,9979,6804,3413,3391
249,1,3619000,3,22410,1,2329940,01/02/2022,21,20345,10131,10214,6733,3300,3433
250,1,16363000,3,37663,1,10598287,01/02/2022,18.1,31115,15891,15224,10525,5240,5285
251,1,10458000,3,44519,1,6753181,01/02/2022,18.1,16550,8456,8094,5252,2552,2700
252,1,13055000,3,24302,1,8461448,01/02/2022,20.1,24352,12627,11725,8092,4062,4030
253,1,18933000,3,35483,1,12270967,01/02/2022,15.9,94978,48709,46269,29794,14672,15122
254,1,21544000,3,26170,1,13977430,01/02/2022,21.9,52019,26739,25280,15725,7759,7966
255,1,3023000,3,23058,1,1941892,01/02/2022,17.8,24580,12765,11815,8215,4057,4158
256,1,10707000,3,23327,1,6936223,01/02/2022,17.8,28678,14679,13999,9074,4497,4577
257,1,3228000,3,22798,1,2075402,01/02/2022,14.2,22738,11719,11019,7000,3537,3463
258,1,8513000,3,23202,1,5510248,01/02/2022,18.8,28145,14670,13475,8863,4390,4473
259,1,6779000,3,28042,1,4378308,01/02/2022,18.8,19113,9852,9261,5504,2716,2788
260,1,1505000,3,23401,1,954849,01/02/2022,14.8,25925,13382,12543,8585,4189,4396
261,1,797000,3,22798,1,495252,01/02/2022,17.8,13033,6697,6336,4420,2181,2239
262,1,2185000,3,22275,1,1397975,01/02/2022,8.5,5955,3118,2837,1972,974,998
263,1,1360000,3,20147,1,863853,01/02/2022,18.1,8850,4524,4326,2773,1377,1396
264,1,1989000,3,21211,1,1271639,01/02/2022,14.2,9529,4943,4586,3018,1490,1528
265,1,8069000,3,26105,1,5218745,01/02/2022,14.8,14636,7533,7103,4910,2424,2486
266,1,14346000,3,33680,1,9291220,01/02/2022,18.1,40906,20800,20106,12864,6409,6455
267,1,5917000,3,25244,1,3820806,01/02/2022,18.8,8142,4289,3853,2686,1333,1353
268,1,1956000,3,22410,1,1248990,01/02/2022,14.2,7954,4060,3894,2570,1274,1296
269,1,8889000,3,24471,1,5753379,01/02/2022,18.1,17000,8527,8473,5215,2549,2666
270,1,2890000,3,22454,1,1856046,01/02/2022,15.6,14424,7439,6985,5399,2678,2721
271,1,2288000,3,23265,1,1463935,01/02/2022,18.1,16873,8725,8148,6022,3008,3014
272,1,2125000,3,17972,1,1363278,01/02/2022,18.8,5109,2618,2491,1631,805,826
273,1,1929000,3,23013,1,1230837,01/02/2022,18.8,13243,6795,6448,4043,1954,2089
274,1,2161000,3,21462,1,1383188,01/02/2022,14.8,14497,7627,6870,4260,2099,2161
275,1,1834000,3,19343,1,1172757,01/02/2022,19.3,16324,8373,7951,5562,2774,2788
276,1,4657000,3,24706,1,3002344,01/02/2022,25.3,9842,5047,4795,3323,1629,1694
277,1,2596000,3,21678,1,1665722,01/02/2022,14.8,27833,14525,13308,9097,4581,4516
278,1,4073000,3,4017,1,2643433,01/02/2022,19.4,33284,17172,16112,10804,5349,5455
279,1,1522000,3,21727,1,967573,01/02/2022,22.7,14697,7601,7096,4740,2380,2360
280,1,3075000,3,17835,1,1980915,01/02/2022,15.9,18607,9363,9244,6403,3178,3225
284,2,91438000,1,163802,2,59270898,01/02/2022,20.2,743275,388114,355161,202467,99875,102592
285,2,32915000,2,89394,2,21305356,01/02/2022,16.1,154546,80401,74145,48513,24003,24510
286,2,60653000,2,96237,2,39328213,01/02/2022,17.2,299523,155411,144112,93845,46362,47483
287,2,38833000,2,61368,2,25180082,01/02/2022,26.8,83637,42325,41312,24783,12286,12497
288,2,36879000,2,65795,2,23905555,01/02/2022,27.5,102362,52461,49901,35162,17416,17746
289,1,15228000,3,33241,1,9864959,01/02/2022,14.2,55287,28877,26410,16959,8447,8512
290,1,18569000,3,38586,1,12031264,01/02/2022,19.5,87042,45232,41810,26414,12958,13456
291,2,31548000,2,55488,2,20450712,01/02/2022,9.4,86901,45620,41281,26262,13160,13102
292,1,19015000,3,22525,1,12337225,01/02/2022,17.6,30519,15931,14588,10809,5325,5484
293,1,28602000,3,33726,1,18557574,01/02/2022,14.2,60811,31893,28918,19713,9706,10007
294,1,3004000,3,9164,1,1943436,01/02/2022,14.3,61510,31765,29745,21000,10487,10513
295,1,19549000,3,47436,1,12659414,01/02/2022,16.4,70042,36241,33801,21818,10809,11009
296,1,3703000,3,9294,1,2397656,01/02/2022,17.4,24662,12965,11697,6937,3350,3587
297,1,5244000,3,19888,1,3388712,01/02/2022,14.3,15414,7999,7415,4635,2291,2344
298,1,19947000,3,24302,1,12941248,01/02/2022,15.8,71528,37497,34031,23278,11539,11739
299,1,2029000,3,23835,1,1295015,01/02/2022,17.6,15249,7932,7317,4894,2453,2441
300,1,23266000,3,23732,1,15099168,01/02/2022,15.7,39425,20578,18847,13203,6477,6726
301,1,3020000,3,24827,1,1938173,01/02/2022,17.4,17293,8766,8527,5650,2795,2855
302,1,10673000,3,24302,1,6913148,01/02/2022,9.4,16905,8772,8133,5514,2740,2774
303,1,3289000,3,22454,1,2115396,01/02/2022,14.2,18097,9360,8737,5881,2892,2989
304,1,11913000,3,23732,1,7719718,01/02/2022,18.1,32333,16690,15643,10314,5057,5257
305,1,15990000,3,25638,1,10367862,01/02/2022,16.9,49940,25545,24395,16071,7998,8073
306,1,13568000,3,25638,1,8793562,01/02/2022,16.4,1049,546,503,282,149,133
307,1,12317000,3,24302,1,7981748,01/02/2022,17.3,6853,3584,3269,2311,1149,1162
308,1,6454000,3,4800,1,4190300,01/02/2022,26.3,12262,6119,6143,4251,2104,2147
309,1,1831000,3,27319,1,1162831,01/02/2022,16.9,11086,5609,5477,3615,1780,1835
311,2,45514000,1,134565,2,29449535,01/02/2022,21.9,341029,180370,160659,82444,40670,41774
312,2,63167000,2,95611,2,40962939,01/02/2022,22,157336,82380,74956,43883,21497,22386
313,1,18927000,3,8876,1,12293674,01/02/2022,25,174629,91268,83361,46521,22880,23641
314,1,27468000,3,44501,1,17809699,01/02/2022,23.7,104461,54150,50311,30967,15315,15652
315,1,14222000,3,47390,1,9196910,01/02/2022,22.5,44353,23038,21315,13070,6400,6670
316,1,4203000,3,25171,1,2706779,01/02/2022,24.6,21375,11206,10169,5662,2753,2909
317,1,28844000,3,38487,1,18710113,01/02/2022,25.4,17777,9225,8552,4254,2086,2168
318,2,33660000,2,90473,2,21788527,01/02/2022,25,64084,32934,31150,19785,9668,10117
319,1,13220000,3,26695,1,8566305,01/02/2022,23.6,20434,10867,9567,5939,2970,2969
320,1,13473000,3,24836,1,8732614,01/02/2022,17.6,19085,9763,9322,6343,3119,3224
321,2,80580000,1,111843,2,52265157,01/02/2022,17.6,371387,192530,178857,106784,52432,54352
322,1,19800000,3,21787,1,12848213,01/02/2022,21.3,18023,9240,8783,5154,2503,2651
323,1,11739000,3,43516,1,7586834,01/02/2022,20,20322,10479,9843,6201,3025,3176
324,1,15137000,3,28587,1,9810463,01/02/2022,20,25477,13300,12177,8208,4059,4149
325,1,8356000,3,48604,1,5382796,01/02/2022,22.3,13620,7015,6605,4098,1994,2104
326,1,10633000,3,24051,1,6887399,01/02/2022,20,48170,25016,23154,15515,7657,7858
327,1,4355000,3,27887,1,2802863,01/02/2022,25.9,10593,5340,5253,3485,1705,1780
328,2,32985000,2,72181,2,21368069,01/02/2022,21.3,8730,4395,4335,2894,1447,1447
329,1,4112000,3,23401,1,2649399,01/02/2022,22.9,14678,7367,7311,4863,2405,2458
330,1,6237000,3,22877,1,4031173,01/02/2022,21.3,10935,5450,5485,3532,1706,1826
331,1,8087000,3,21929,1,5234621,01/02/2022,23.8,19976,10345,9631,6431,3120,3311
332,2,46100000,2,99407,2,29865593,01/02/2022,14.6,412199,209241,202958,82879,40585,42294
333,2,47768000,1,114365,2,30934835,01/02/2022,15.4,304052,152635,151417,84118,41457,42661
334,2,71830000,1,129564,2,46559936,01/02/2022,13.4,536436,267279,269157,158598,77797,80801
335,2,95500000,1,133570,2,61941430,01/02/2022,13.4,635862,320627,315235,153834,75737,78097
336,3,113070000,1,203253,3,73292247,01/02/2022,13.3,1142952,578172,564780,270109,132170,137939
338,1,13280000,3,45382,1,8586618,01/02/2022,13.4,75721,38037,37684,21903,10795,11108
339,1,15377000,3,31339,1,9963711,01/02/2022,14.4,70378,35870,34508,21367,10464,10903
340,2,35818000,3,22257,2,23259443,01/02/2022,11.1,308285,152976,155309,108145,53196,54949
342,2,30945000,2,62123,2,20052127,01/02/2022,13.4,234698,115478,119220,87040,43098,43942
343,1,9835000,3,27317,1,6365433,01/02/2022,13.4,28843,14318,14525,8529,4190,4339
344,1,9827000,3,25197,1,6362353,01/02/2022,15,33522,17126,16396,9330,4711,4619
345,1,12456000,3,46491,1,8049909,01/02/2022,13.9,54467,27606,26861,15858,7789,8069
346,1,12213000,3,19225,1,7919225,01/02/2022,14.6,13059,6525,6534,4137,2073,2064
347,1,982000,3,3850,1,634450,01/02/2022,11.1,9934,4952,4982,3082,1558,1524
348,1,4226000,3,25620,1,2721280,01/02/2022,11.1,7844,4131,3713,2621,1355,1266
349,1,7758000,3,47968,1,4994732,01/02/2022,13.4,48069,23121,24948,16392,8040,8352
350,1,8618000,3,22018,1,5579682,01/02/2022,15.4,11583,5810,5773,3713,1872,1841
351,1,4919000,3,20527,1,3176823,01/02/2022,23.4,29903,15539,14364,9778,4798,4980
352,3,117333000,1,249826,3,76016624,01/02/2022,21.8,258913,138803,120110,68042,33683,34359
353,2,41777000,2,76502,2,27078548,01/02/2022,22.6,103609,54904,48705,31555,15575,15980
354,1,24117000,2,67290,1,15608760,01/02/2022,26.9,76660,40113,36547,21596,10646,10950
355,2,33443000,3,48620,2,21689330,01/02/2022,28.1,88280,46038,42242,25864,12608,13256
356,1,25707000,2,55665,1,16653885,01/02/2022,19.2,56163,29689,26474,18214,8872,9342
357,1,2168000,3,29221,1,1379979,01/02/2022,22.6,7263,3837,3426,2540,1279,1261
358,1,13697000,3,22396,1,8880654,01/02/2022,26.8,16645,8759,7886,5075,2484,2591
359,1,11540000,3,49836,1,7451164,01/02/2022,22.2,31469,16729,14740,9837,4899,4938
360,1,13061000,3,22542,1,8467108,01/02/2022,14.1,12729,6935,5794,4541,2296,2245
361,1,11775000,3,24769,1,7628981,01/02/2022,28.1,26015,13735,12280,7360,3633,3727
362,2,37081000,3,27180,2,24075470,01/02/2022,23.4,29903,15539,14364,9778,4798,4980
363,1,22530000,3,41714,1,14602786,01/02/2022,27,10504,5405,5099,3440,1722,1718
364,1,15639000,3,23500,1,10141850,01/02/2022,27,45134,23442,21692,13494,6690,6804
365,1,18348000,3,47222,1,11878978,01/02/2022,18.2,29130,15431,13699,9957,5019,4938
366,1,3975000,3,18675,1,2565075,01/02/2022,21.7,5812,3105,2707,1767,906,861
367,1,11923000,3,23775,1,7726175,01/02/2022,14.1,15851,8463,7388,5625,2839,2786
368,1,4329000,3,23530,1,2790320,01/02/2022,18.2,15298,8185,7113,4499,2268,2231
369,1,22369000,3,27582,1,14512268,01/02/2022,28.1,17525,9370,8155,5075,2488,2587
370,1,16889000,2,70324,1,10907526,01/02/2022,14.1,18915,10248,8667,6395,3217,3178
371,1,18873000,3,20324,1,12247126,01/02/2022,20.1,81848,43535,38313,23849,11894,11955
372,2,32452000,3,34032,2,21059768,01/02/2022,20.1,33726,17513,16213,11096,5372,5724
373,1,1883000,3,19888,1,1204062,01/02/2022,18.2,11168,5931,5237,3889,1954,1935
374,1,4431000,3,23265,1,2856885,01/02/2022,22.6,6341,3343,2998,2049,979,1070
375,1,18157000,3,13056,1,11788994,01/02/2022,20.1,45895,23816,22079,12162,5997,6165
376,1,5123000,3,26725,1,3303225,01/02/2022,21.9,6863,3664,3199,2612,1321,1291
377,1,9344000,3,23861,1,6049739,01/02/2022,20.1,10611,5602,5009,3876,1871,2005
378,1,3026000,3,24827,1,1942073,01/02/2022,26.8,14226,7514,6712,4380,2214,2166
379,1,4328000,3,20350,1,2792850,01/02/2022,20.1,7997,4114,3883,2359,1161,1198
380,1,3685000,3,9473,1,2385777,01/02/2022,22.2,4188,2243,1945,1509,761,748
381,1,24842000,2,56455,1,16090845,01/02/2022,23.4,15373,8115,7258,5203,2638,2565
382,1,14859000,3,22956,1,9635394,01/02/2022,27.3,14071,7408,6663,4497,2251,2246
383,1,1617000,3,20341,1,1030709,01/02/2022,14.3,6642,3720,2922,2058,1005,1053
384,1,6326000,3,5831,1,4106069,01/02/2022,26.6,11054,5638,5416,3563,1745,1818
385,3,180125000,1,390514,3,116690736,01/02/2022,16.5,1542232,806262,735970,402209,198130,204079
386,2,41734000,2,56275,2,27070825,01/02/2022,13.7,78264,40929,37335,23163,11368,11795
387,2,50743000,2,70188,2,32912762,01/02/2022,17.1,293825,155300,138525,93203,46206,46997
388,1,22519000,3,42077,1,14595273,01/02/2022,23.3,49578,26095,23483,16381,8171,8210
389,2,29927000,3,33836,2,19418714,01/02/2022,17.7,89314,47398,41916,25892,12760,13132
390,2,35464000,3,32339,2,23019261,01/02/2022,15.1,31315,16320,14995,10348,5100,5248
391,1,14998000,3,46354,1,9702346,01/02/2022,11.4,39203,20881,18322,12964,6446,6518
392,1,17445000,3,47179,1,11292071,01/02/2022,13.9,58957,31503,27454,19229,9506,9723
393,2,29733000,2,79062,2,19247388,01/02/2022,11.4,62849,33939,28910,17954,8876,9078
394,1,15879000,3,31496,1,10289854,01/02/2022,12.6,25468,13582,11886,8293,4136,4157
395,1,18994000,3,44587,1,12301513,01/02/2022,11.4,31599,16595,15004,11708,5967,5741
396,1,22891000,3,50483,1,14828667,01/02/2022,11.4,29123,15247,13876,9589,4733,4856
397,1,13100000,3,24128,1,8490872,01/02/2022,15,18110,9443,8667,6325,3046,3279
398,1,10445000,3,37901,1,6751349,01/02/2022,11.4,31695,16422,15273,11280,5582,5698
399,1,13615000,3,32023,1,8817727,01/02/2022,11.4,95322,48884,46438,32521,16133,16388
400,1,13016000,3,26234,1,8434166,01/02/2022,11.4,9358,5013,4345,2738,1323,1415
401,1,9861000,3,47302,1,6362348,01/02/2022,12.1,9149,4948,4201,2691,1357,1334
402,1,2954000,3,22798,1,1897302,01/02/2022,11.4,9913,5282,4631,3496,1711,1785
403,1,8645000,3,8432,1,5610818,01/02/2022,11.4,36620,18819,17801,10303,4961,5342
404,1,1416000,3,34052,1,886348,01/02/2022,11.4,5276,2719,2557,1830,893,937
405,1,15446000,3,25638,1,10014262,01/02/2022,11.4,41455,21994,19461,13993,6843,7150
406,1,12859000,3,23739,1,8334611,01/02/2022,14.4,29613,15403,14210,9414,4672,4742
408,1,8540000,3,25926,1,5525074,01/02/2022,13.8,13922,7166,6756,5211,2590,2621
409,1,3016000,3,21210,1,1939190,01/02/2022,11.4,10960,5789,5171,3556,1785,1771
410,1,10230000,3,25638,1,6623862,01/02/2022,10.4,22904,12086,10818,7644,3743,3901
411,1,6229000,3,22533,1,4026317,01/02/2022,11.4,11776,6077,5699,3730,1832,1898
412,1,1479000,3,8432,1,952918,01/02/2022,11.4,16797,8560,8237,5425,2652,2773
413,1,2955000,3,22798,1,1897952,01/02/2022,11.4,19648,10052,9596,6751,3334,3417
414,1,12142000,3,26234,1,7866066,01/02/2022,21.8,19341,10302,9039,6428,3158,3270
415,1,2294000,3,24181,1,1466919,01/02/2022,14,11487,6208,5279,3749,1855,1894
416,1,4477000,3,17502,1,2892548,01/02/2022,11.4,5703,2985,2718,1959,971,988
417,1,1531000,3,20005,1,975145,01/02/2022,11.4,6644,3435,3209,2305,1130,1175
418,1,2706000,3,14463,1,1744437,01/02/2022,11.4,7491,3982,3509,2583,1266,1317
419,1,1691000,3,11877,1,1087273,01/02/2022,11.4,8481,4360,4121,2849,1391,1458
420,1,18094000,3,32754,1,11728346,01/02/2022,15.8,46996,24240,22756,12187,6012,6175
421,1,2185000,3,20343,1,1399907,01/02/2022,17.9,8445,4468,3977,3005,1505,1500
422,1,4753000,3,21275,1,3068175,01/02/2022,13.7,5612,3027,2585,1851,938,913
423,1,5307000,3,22581,1,3426969,01/02/2022,23.2,5276,2719,2557,1830,893,937
424,3,145688000,1,220846,3,94476354,01/02/2022,17.4,794789,407239,387550,199480,98049,101431
425,2,37158000,2,56377,2,24096323,01/02/2022,14.7,177719,91525,86194,50219,24680,25539
426,1,14741000,3,25256,1,9556394,01/02/2022,14.7,34955,18206,16749,9854,4805,5049
427,1,1572000,3,21118,1,1000682,01/02/2022,14.3,115264,60166,55098,28758,14392,14366
428,1,13062000,3,22921,1,8467379,01/02/2022,14.7,16795,8697,8098,5436,2628,2808
429,1,5282000,3,22454,1,3410846,01/02/2022,16.8,13390,6831,6559,4033,1966,2067
430,1,6128000,3,23529,1,3959671,01/02/2022,16.8,7953,4224,3729,2375,1195,1180
431,1,5820000,3,17612,1,3765388,01/02/2022,19.7,15512,8121,7391,5093,2493,2600
432,2,47379000,3,44166,2,30752184,01/02/2022,25.9,169028,86790,82238,45879,22689,23190
433,3,133795000,1,143895,3,86822855,01/02/2022,26.7,888797,441181,447616,247410,121384,126026
434,2,63129000,2,69467,2,40964383,01/02/2022,23.7,304942,149380,155562,85665,42398,43267
435,1,20309000,3,50724,1,13150126,01/02/2022,26.6,84519,42292,42227,24955,12440,12515
436,1,15085000,3,21585,1,9783665,01/02/2022,25,30754,15948,14806,10320,5221,5099
437,3,109702000,1,121569,3,71184731,01/02/2022,14.9,845941,437370,408571,227808,112567,115241
438,2,46108000,2,58745,2,29911455,01/02/2022,20.2,136351,71718,64633,38918,19062,19856
439,1,24438000,3,51078,1,15833622,01/02/2022,15.8,86686,44901,41785,27406,13467,13939
440,1,28440000,3,44880,1,18441120,01/02/2022,18.9,58158,30570,27588,17715,8934,8781
441,1,21988000,2,64007,1,14228193,01/02/2022,21,24258,12834,11424,7258,3602,3656
442,1,10732000,3,26105,1,6949695,01/02/2022,20,24454,12691,11763,7326,3576,3750
443,1,18029000,3,27996,1,11690854,01/02/2022,14.9,310192,159130,151062,94872,46787,48085
444,1,2311000,3,25224,1,1476926,01/02/2022,16.7,14340,7646,6694,4731,2430,2301
445,2,50993000,2,68941,2,33076509,01/02/2022,20,15341,8078,7263,4842,2416,2426
446,1,3942000,3,25294,1,2537006,01/02/2022,21,8045,4283,3762,2501,1247,1254
447,1,7633000,3,22992,1,4938458,01/02/2022,21,6644,3540,3104,2086,1058,1028
448,1,3035000,3,20687,1,1952063,01/02/2022,20,16582,8647,7935,5030,2477,2553
449,1,21517000,2,64444,1,13921606,01/02/2022,20.9,30796,15740,15056,9239,4503,4736
450,2,53083000,2,75968,2,34427982,01/02/2022,19.4,77849,40866,36983,21990,10871,11119
451,1,26688000,3,38402,1,17308798,01/02/2022,20.4,65215,33971,31244,19700,9733,9967
452,2,95357000,1,130432,2,61851618,01/02/2022,19.6,441975,227109,214866,122010,60145,61865
453,3,222938000,1,222862,3,144686838,01/02/2022,21.8,808416,416251,392165,234633,115277,119356
454,2,71752000,1,126893,2,46511907,01/02/2022,19.4,298009,154344,143665,83869,41238,42631
455,1,12941000,3,21860,1,8389790,01/02/2022,24.1,33924,17240,16684,10629,5267,5362
456,1,10154000,3,30468,1,6569632,01/02/2022,18.7,14772,7516,7256,4444,2199,2245
457,1,17790000,3,31368,1,11532132,01/02/2022,20,19742,9908,9834,6831,3367,3464
458,1,8413000,3,26938,1,5441512,01/02/2022,19.1,12848,6693,6155,3711,1831,1880
459,1,9762000,3,32794,1,6312506,01/02/2022,18.6,5457,2839,2618,1473,755,718
460,1,5236000,3,26578,1,3376822,01/02/2022,19.2,5926,3043,2883,1700,842,858
461,1,8712000,3,25761,1,5637039,01/02/2022,24.1,17097,8801,8296,5359,2662,2697
462,1,13654000,3,50156,1,8824944,01/02/2022,20.9,28239,14113,14126,8795,4312,4483
463,1,10100000,3,22863,1,6542137,01/02/2022,20.4,16934,8502,8432,5395,2626,2769
464,1,11076000,3,48351,1,7151049,01/02/2022,18.4,11851,5973,5878,3739,1841,1898
465,1,6325000,3,33104,1,4078146,01/02/2022,19.4,25157,12582,12575,8765,4230,4535
466,1,3074000,3,21553,1,1976547,01/02/2022,26.9,6055,3107,2948,1652,803,849
467,1,2855000,3,23142,1,1832608,01/02/2022,19.4,22421,11364,11057,6263,3134,3129
468,1,1809000,3,22798,1,1153052,01/02/2022,20.4,9864,5093,4771,3123,1529,1594
469,1,2340000,3,17957,1,1503043,01/02/2022,21.2,7888,4037,3851,3058,1509,1549
470,1,4005000,3,25171,1,2578079,01/02/2022,18.6,5524,2885,2639,1817,894,923
472,1,2805000,3,34806,1,1788444,01/02/2022,22.3,10328,5288,5040,3690,1794,1896
473,1,816000,3,4592,1,525808,01/02/2022,21.2,4810,2229,2581,1556,759,797
474,2,63916000,1,127657,2,41417743,01/02/2022,19.7,329404,168547,160857,90108,44605,45503
475,3,115821000,1,258046,3,75025604,01/02/2022,18.4,855563,431621,423942,240318,117646,122672
476,1,24351000,2,65835,1,15762315,01/02/2022,16.3,117253,59414,57839,33098,16300,16798
477,2,49598000,2,61485,2,32177215,01/02/2022,15,176685,87738,88947,53884,26504,27380
478,2,50581000,1,116326,2,32761324,01/02/2022,10.2,261137,131158,129979,84004,41439,42565
479,2,29894000,3,46943,2,19384157,01/02/2022,17.4,120926,61958,58968,34805,17098,17707
480,1,19570000,3,31728,1,12688772,01/02/2022,24,67604,34141,33463,21101,10330,10771
481,1,10257000,3,24127,1,6642923,01/02/2022,17.9,38886,19733,19153,11641,5731,5910
482,1,11804000,3,22052,1,7650548,01/02/2022,15.9,30324,15540,14784,8298,4088,4210
483,1,18482000,3,35334,1,11977966,01/02/2022,9.6,91029,45722,45307,30379,15003,15376
484,1,17978000,3,26019,1,11659681,01/02/2022,16.5,62301,30877,31424,20494,10127,10367
485,1,2109000,3,21462,1,1349388,01/02/2022,24.5,12987,6460,6527,4296,2156,2140
486,1,9611000,3,27415,1,6219735,01/02/2022,10.9,38113,19225,18888,12385,6138,6247
487,1,1724000,3,22798,1,1097802,01/02/2022,17.8,12372,6340,6032,3845,1851,1994
488,1,8615000,3,22619,1,5577131,01/02/2022,14.1,39474,19169,20305,14904,7336,7568
489,1,8297000,3,26844,1,5366206,01/02/2022,13.9,30429,15578,14851,9786,4826,4960
490,1,3921000,3,25638,1,2523012,01/02/2022,15.2,13153,6653,6500,4059,2009,2050
491,1,4307000,3,25767,1,2773783,01/02/2022,12.7,11440,5836,5604,4121,2095,2026
492,1,1796000,3,25599,1,1141801,01/02/2022,13.2,4787,2437,2350,1357,684,673
493,2,88166000,1,150782,2,57157118,01/02/2022,23.3,340060,178122,161938,86078,42456,43622
494,2,42926000,3,41058,2,27860842,01/02/2022,24.5,43035,22773,20262,11996,6054,5942
495,1,18239000,3,32825,1,11822525,01/02/2022,26.4,27182,14325,12857,8434,4220,4214
496,1,13722000,3,24302,1,8894998,01/02/2022,24.5,21003,10909,10094,6452,3209,3243
497,1,21532000,3,32010,1,13963790,01/02/2022,25,31435,16316,15119,9125,4445,4680
498,1,15606000,3,42392,1,10101508,01/02/2022,23.7,29068,15153,13915,8638,4280,4358
499,1,17169000,3,22058,1,11137792,01/02/2022,24.9,25555,13197,12358,7191,3479,3712
500,1,6248000,3,20958,1,4040242,01/02/2022,25.6,13944,7272,6672,4420,2177,2243
501,1,16030000,3,21585,1,10397915,01/02/2022,24.7,34946,17956,16990,11208,5422,5786
502,1,12346000,3,21653,1,8003247,01/02/2022,24.2,16679,8618,8061,4633,2284,2349
503,2,51785000,2,74493,2,33585757,01/02/2022,19.1,297373,155718,141655,71865,35366,36499
504,3,129824000,1,182440,3,84203160,01/02/2022,14.3,691557,348387,343170,213267,104895,108372
505,2,64294000,2,70615,2,41720485,01/02/2022,15.2,416055,211059,204996,132268,65355,66913
506,1,15338000,3,32773,1,9936927,01/02/2022,14.9,111314,55902,55412,35576,17423,18153
507,2,58829000,2,86832,2,38152018,01/02/2022,16.9,332100,171749,160351,94911,46503,48408
508,1,27822000,3,42142,1,18042158,01/02/2022,20.6,79515,41903,37612,21445,10720,10725
509,1,25996000,3,50687,1,16846713,01/02/2022,18.8,205933,107685,98248,49242,24249,24993
510,1,11229000,3,24471,1,7274379,01/02/2022,15.1,48172,24667,23505,15031,7399,7632
511,1,9273000,3,23958,1,6003492,01/02/2022,14.9,18592,8945,9647,4116,2046,2070
512,1,25814000,3,37967,1,16741133,01/02/2022,19.3,79824,40689,39135,24808,12213,12595
513,1,2111000,3,19876,1,1352274,01/02/2022,14.9,10327,5388,4939,2996,1506,1490
514,1,6377000,3,18810,1,4126240,01/02/2022,14.9,28215,14347,13868,9384,4582,4802
515,1,1370000,3,1474,1,889026,01/02/2022,19.5,10993,5737,5256,3544,1803,1741
517,1,23161000,3,36930,1,15017720,01/02/2022,11.7,53373,27810,25563,15744,7755,7989
518,2,29324000,2,74351,2,18986249,01/02/2022,15.1,13555,7357,6198,3051,1547,1504
519,1,22026000,3,37770,1,14279130,01/02/2022,11.9,59871,31271,28600,19112,9469,9643
520,2,38874000,2,63485,2,25204615,01/02/2022,13.2,47632,25410,22222,12563,6265,6298
521,1,17247000,3,34464,1,11176086,01/02/2022,14.1,45587,23716,21871,14000,6913,7087
522,1,11304000,3,23732,1,7323868,01/02/2022,11.2,37704,19683,18021,12453,6131,6322
523,1,12568000,3,15323,1,8153877,01/02/2022,11.7,70224,35655,34569,24421,12033,12388
524,1,2892000,3,22066,1,1857734,01/02/2022,11.7,17978,9382,8596,6248,3105,3143
525,1,980000,3,23594,1,613406,01/02/2022,11.7,13401,6929,6472,4288,2149,2139
526,1,1392000,3,17132,1,887668,01/02/2022,11.7,30417,15670,14747,9405,4719,4686
527,1,5405000,3,6920,1,3506330,01/02/2022,11.7,28657,14853,13804,9078,4552,4526
528,1,1118000,3,11206,1,715494,01/02/2022,11.7,1583,826,757,480,230,250
529,2,46750000,2,79378,2,30308122,01/02/2022,18.6,139075,74465,64610,36819,18286,18533
530,2,53556000,2,72367,2,34739033,01/02/2022,17.4,120500,65043,55457,29046,14403,14643
531,2,56582000,3,51927,2,36726373,01/02/2022,26.9,101336,54039,47297,24763,12096,12667
532,3,115779000,1,278310,3,74978040,01/02/2022,22.4,405952,215818,190134,89205,43880,45325
533,2,47120000,2,94749,2,30533251,01/02/2022,22.9,212540,111746,100794,51580,25268,26312
534,2,50926000,1,117184,2,32984716,01/02/2022,19,180057,96347,83710,45301,22589,22712
535,2,63607000,1,186497,2,41158053,01/02/2022,16.7,443063,237967,205096,110147,54509,55638
536,1,21800000,3,26836,1,14143164,01/02/2022,18.6,33226,17650,15576,10241,5095,5146
537,1,7677000,3,33571,1,4956479,01/02/2022,23.1,15512,8193,7319,4859,2440,2419
538,2,33677000,3,48391,2,21841659,01/02/2022,20.1,64445,34215,30230,17692,8626,9066
539,2,30816000,3,45162,2,19985238,01/02/2022,23.5,48567,25769,22798,13570,6693,6877
540,1,19146000,3,27267,1,12417633,01/02/2022,11.3,42451,22342,20109,14824,7241,7583
541,1,17043000,3,24892,1,11053058,01/02/2022,19.9,41588,21739,19849,12522,6161,6361
543,1,21433000,3,44461,1,13886989,01/02/2022,19,55452,29697,25755,14940,7380,7560
544,1,1303000,3,21553,1,825397,01/02/2022,22.4,6076,3180,2896,1703,844,859
545,2,35857000,2,54469,2,23252581,01/02/2022,19,64692,34002,30690,19678,9778,9900
546,1,1548000,3,20965,1,985235,01/02/2022,22,22760,12125,10635,6420,3229,3191
547,1,13222000,3,33495,1,8560805,01/02/2022,22,25608,13480,12128,7723,3870,3853
548,1,9689000,3,50937,1,6246913,01/02/2022,20.1,15733,8506,7227,4079,2054,2025
549,1,6272000,3,22921,1,4053879,01/02/2022,17.4,41785,22480,19305,10854,5445,5409
550,1,8034000,3,35862,1,5186238,01/02/2022,21.5,13225,6946,6279,3476,1669,1807
551,1,12055000,3,32694,1,7803056,01/02/2022,17.3,28655,15243,13412,8764,4302,4462
552,1,5577000,3,35269,1,3589781,01/02/2022,21.1,17727,9423,8304,4199,2068,2131
553,1,11234000,2,91623,1,7210477,01/02/2022,23.1,8969,4883,4086,2821,1444,1377
554,1,9645000,3,23998,1,6245252,01/02/2022,23.5,16758,8967,7791,4993,2542,2451
555,2,30186000,3,51308,2,19569592,01/02/2022,23.3,47035,25085,21950,12872,6289,6583
556,1,15924000,3,25937,1,10324663,01/02/2022,22.1,55720,29557,26163,14521,7123,7398
557,1,17815000,3,28860,1,11550890,01/02/2022,20.5,46909,24866,22043,15156,7483,7673
558,1,11801000,3,31253,1,7639397,01/02/2022,20.5,33986,17827,16159,9043,4421,4622
559,1,12616000,3,22396,1,8178004,01/02/2022,17.4,34847,18666,16181,8943,4380,4563
560,1,12684000,3,34152,1,8210448,01/02/2022,22.1,14304,7545,6759,4455,2182,2273
561,1,6987000,3,21929,1,4519621,01/02/2022,26,20797,10995,9802,4991,2418,2573
562,1,13839000,3,22396,1,8972954,01/02/2022,22,30232,15727,14505,8913,4281,4632
563,1,21944000,2,59571,1,14204029,01/02/2022,21.5,20165,10621,9544,5395,2701,2694
564,1,2121000,3,19834,1,1358816,01/02/2022,19,20380,10692,9688,6259,3127,3132
565,1,8777000,3,21670,1,5683380,01/02/2022,11.4,21640,11976,9664,7433,3885,3548
566,1,19813000,3,30464,1,12847986,01/02/2022,13.8,33402,17876,15526,9753,4761,4992
567,1,21128000,3,42127,1,13691073,01/02/2022,19.2,26236,13620,12616,8067,3962,4105
568,1,3157000,3,32334,1,2019716,01/02/2022,23,4405,2358,2047,1451,735,716
569,1,3290000,3,25638,1,2112862,01/02/2022,22,13716,7109,6607,3981,1920,2061
570,1,11078000,3,23388,1,7177312,01/02/2022,22.1,5653,2987,2666,1709,826,883
571,1,8266000,3,26839,1,5346061,01/02/2022,21.1,21318,11472,9846,5688,2873,2815
572,1,9027000,3,24264,1,5843286,01/02/2022,22.1,14582,7621,6961,4539,2262,2277
573,1,1388000,3,29351,1,872849,01/02/2022,22.6,6219,3311,2908,1883,941,942
574,1,7609000,3,32222,1,4913628,01/02/2022,23.7,31856,17018,14838,8563,4318,4245
575,1,13705000,3,22877,1,8885373,01/02/2022,17.4,35893,18883,17010,11399,5600,5799
576,1,14591000,3,25508,1,9458642,01/02/2022,21.1,19272,10328,8944,5163,2534,2629
577,1,14417000,3,26105,1,9344945,01/02/2022,11.4,16364,8711,7653,5250,2654,2596
578,1,8920000,3,23978,1,5774022,01/02/2022,22.4,2820,1449,1371,720,341,379
579,1,2241000,3,23713,1,1432937,01/02/2022,22.8,4654,2510,2144,1296,630,666
580,1,1314000,3,22754,1,831346,01/02/2022,11.4,21585,11243,10342,6456,3197,3259
581,1,1190000,3,25294,1,748206,01/02/2022,22.1,6888,3543,3345,1840,922,918
582,1,1572000,3,23996,1,997804,01/02/2022,22.2,21391,11404,9987,5619,2742,2877
583,1,1277000,3,22927,1,807123,01/02/2022,22,9668,5030,4638,2384,1141,1243
584,1,14410000,3,23265,1,9343235,01/02/2022,23.7,13995,7311,6684,4212,2070,2142
585,1,3873000,3,23400,1,2494050,01/02/2022,22.1,6838,3583,3255,1791,891,900
586,1,1177000,3,23530,1,741520,01/02/2022,22.2,5681,3058,2623,1606,823,783
587,1,7075000,3,23394,1,4575356,01/02/2022,11.4,13966,7679,6287,3739,1859,1880
588,1,10380000,3,15711,1,6731289,01/02/2022,22.9,28076,14773,13303,7550,3752,3798
589,1,5275000,3,22525,1,3406225,01/02/2022,11.1,34039,18008,16031,8858,4334,4524
590,1,1563000,3,19171,1,996779,01/02/2022,17.4,15807,8231,7576,5949,2955,2994
591,1,1173000,3,13076,1,749374,01/02/2022,22.1,10581,5508,5073,2907,1418,1489
592,1,2936000,3,22274,1,1886126,01/02/2022,13.8,9554,4935,4619,2707,1302,1405
593,1,11122000,3,45394,1,7183906,01/02/2022,20.5,9988,5342,4646,2237,1127,1110
594,1,1801000,3,13593,1,1157057,01/02/2022,20.2,7578,3984,3594,2088,1031,1057
595,1,2059000,3,33321,1,1305029,01/02/2022,15.9,8005,4106,3899,2599,1296,1303
596,1,2208000,3,20815,1,1414385,01/02/2022,22.9,24085,12288,11797,7909,3780,4129
597,1,3256000,3,21541,1,2094859,01/02/2022,22.2,7455,4054,3401,2223,1145,1078
598,1,873000,3,8527,1,558923,01/02/2022,22.6,17919,9538,8381,4548,2298,2250
599,1,4525000,3,5730,1,2935520,01/02/2022,19,15305,8066,7239,4706,2332,2374
600,3,125425000,1,248242,3,81278008,01/02/2022,25.9,921771,479309,442462,222551,109790,112761
601,1,12140000,3,23265,1,7867735,01/02/2022,23.2,26081,13338,12743,7626,3791,3835
602,1,26661000,3,22462,1,17307188,01/02/2022,25.5,56494,29131,27363,17460,8617,8843
603,1,15762000,3,26578,1,10218722,01/02/2022,24,52593,26982,25611,16883,8307,8576
604,1,4735000,3,29906,1,3047844,01/02/2022,24.5,41965,21110,20855,11192,5453,5739
605,1,8545000,3,26695,1,5527555,01/02/2022,24.5,26175,13553,12622,8885,4301,4584
606,1,10924000,3,23861,1,7076739,01/02/2022,24,35183,17868,17315,10650,5230,5420
607,1,8264000,3,23265,1,5348335,01/02/2022,22.8,56409,28489,27920,16919,8292,8627
608,1,7232000,3,10362,1,4690438,01/02/2022,24.1,139753,70456,69297,45077,22298,22779
609,1,5748000,3,22475,1,3713725,01/02/2022,24,17841,9042,8799,5372,2677,2695
610,1,7401000,3,17612,1,4793038,01/02/2022,24.1,28461,14574,13887,9148,4533,4615
611,2,32026000,2,58654,2,20758246,01/02/2022,14.8,143281,73905,69376,47529,23519,24010
612,2,35803000,2,95850,2,23176100,01/02/2022,12.2,138444,72335,66109,38201,18773,19428
613,1,10152000,3,26667,1,6572133,01/02/2022,14.6,22295,11690,10605,8176,4115,4061
614,1,12197000,3,47197,1,7880853,01/02/2022,13,25068,12776,12292,8673,4237,4436
615,1,2696000,3,25171,1,1727229,01/02/2022,15.1,15291,7886,7405,5051,2477,2574
616,1,4531000,3,23142,1,2922008,01/02/2022,13.8,38193,19467,18726,13775,6896,6879
617,1,9058000,3,25767,1,5861933,01/02/2022,15.2,46132,23831,22301,13972,6871,7101
618,1,1870000,3,21118,1,1194382,01/02/2022,19.2,13641,7027,6614,4307,2133,2174
1,2,78645000,1,192569,2,50926681,01/01/2022,16.1,863893,444725,419168,260350,128225,132125
2,1,13969000,3,31089,1,9048761,01/01/2022,15.8,31963,16433,15530,11390,5609,5781
3,1,8099000,3,27607,1,5236743,01/01/2022,14.1,63805,32406,31399,23397,11652,11745
4,1,7924000,3,26713,1,5123887,01/01/2022,15.8,21049,10874,10175,7097,3529,3568
5,1,3952000,3,29090,1,2539710,01/01/2022,13.9,32035,16367,15668,10989,5374,5615
6,3,149578000,1,284631,3,96941069,01/01/2022,16.6,854186,425977,428209,227917,112151,115766
7,3,315150000,1,586775,3,204260725,01/01/2022,15.1,1810645,899293,911352,503963,246971,256992
8,2,65640000,2,96286,2,42569714,01/01/2022,12.2,330652,167339,163313,86895,42903,43992
9,1,26432000,3,29321,1,17151479,01/01/2022,14.1,81059,40420,40639,23492,11470,12022
10,1,27834000,2,53739,1,18038361,01/01/2022,15.5,100660,49935,50725,28067,13772,14295
11,1,15113000,3,25254,1,9798196,01/01/2022,14.1,19081,9476,9605,5934,2909,3025
12,2,54262000,1,124234,2,35146066,01/01/2022,20.5,250141,126245,123896,65670,32312,33358
13,2,44716000,2,91151,2,28974249,01/01/2022,19.5,136285,66083,70202,42780,21001,21779
14,2,55170000,1,145055,2,35715445,01/01/2022,23.1,202694,98608,104086,64935,31858,33077
15,1,17899000,3,37523,1,11596827,01/01/2022,19,43805,22160,21645,13050,6507,6543
16,1,20858000,2,84886,1,13472814,01/01/2022,20.1,16311,8010,8301,4984,2435,2549
17,1,7783000,3,49021,1,5009929,01/01/2022,18.4,14357,6822,7535,3854,1925,1929
18,1,2296000,3,29556,1,1462844,01/01/2022,15,13596,6842,6754,4196,2086,2110
19,1,7601000,3,48028,1,4892622,01/01/2022,17.4,13596,6842,6754,4196,2086,2110
20,1,2202000,3,29101,1,1402199,01/01/2022,19.4,7185,3509,3676,2099,1015,1084
21,2,37495000,2,69527,2,24302223,01/01/2022,24.2,191238,97313,93925,52600,25862,26738
22,2,38851000,2,73859,2,25179291,01/01/2022,24.1,249623,130524,119099,66498,32635,33863
23,1,22782000,3,30798,1,14777502,01/01/2022,25.3,31375,16375,15000,10682,5317,5365
24,1,16014000,3,29213,1,10379887,01/01/2022,24.2,35799,18291,17508,11962,5883,6079
25,1,10333000,3,30548,1,6685902,01/01/2022,24.5,15949,8217,7732,4538,2234,2304
26,2,71682000,2,91210,2,46502090,01/01/2022,27.5,217550,113613,103937,65123,32048,33075
27,2,41797000,3,48504,2,27119546,01/01/2022,14.4,183509,96930,86579,60413,30246,30167
28,2,43532000,2,81732,2,28214068,01/01/2022,17.9,113479,60064,53415,36594,18199,18395
29,2,92225000,2,101729,2,59844521,01/01/2022,23.8,578830,303756,275074,166456,82025,84431
30,2,30014000,3,38161,2,19470939,01/01/2022,24.1,51797,27093,24704,17614,8812,8802
31,2,49989000,1,130115,2,32362735,01/01/2022,22.7,38087,20017,18070,11916,5833,6083
32,1,11654000,3,25404,1,7549696,01/01/2022,29.9,32109,16780,15329,10495,5074,5421
33,1,20636000,3,25707,1,13387693,01/01/2022,25,21727,11415,10312,7786,3890,3896
34,1,15386000,3,27580,1,9973320,01/01/2022,23,49201,25651,23550,16539,8102,8437
35,1,20040000,3,43685,1,12982315,01/01/2022,22.4,37546,19668,17878,11791,5836,5955
36,1,20976000,2,84246,1,13550154,01/01/2022,17,47688,25247,22441,17870,8920,8950
37,1,4634000,3,26552,1,2985548,01/01/2022,24.5,55931,28786,27145,18430,9082,9348
38,1,10891000,3,29956,1,7049194,01/01/2022,21.5,29018,15064,13954,10291,5191,5100
39,1,9159000,3,49878,1,5903472,01/01/2022,23.1,18219,9592,8627,5806,2838,2968
40,1,11827000,3,30709,1,7656841,01/01/2022,22.9,15244,8058,7186,4848,2429,2419
41,1,4515000,3,25065,1,2909685,01/01/2022,28,25366,13345,12021,7752,3823,3929
42,1,14698000,3,28336,1,9525364,01/01/2022,26.6,19271,9996,9275,6517,3095,3422
43,1,3821000,3,23622,1,2460028,01/01/2022,26.9,7662,4073,3589,2321,1153,1168
45,3,212150000,1,295335,3,137602165,01/01/2022,8.8,1501551,750157,751394,459910,225614,234296
46,2,78212000,1,183741,2,50654059,01/01/2022,10.7,925762,474776,450986,250961,123448,127513
47,1,22333000,2,57957,1,14458493,01/01/2022,12.8,128548,65838,62710,37721,18411,19310
48,1,18765000,3,45556,1,12151694,01/01/2022,10.1,135586,69677,65909,41627,20458,21169
49,1,23450000,2,64586,1,15177914,01/01/2022,12.6,113843,59214,54629,34117,16974,17143
50,1,3998000,3,21065,1,2577635,01/01/2022,14,23140,11693,11447,7155,3499,3656
51,1,7998000,3,27275,1,5171425,01/01/2022,11.8,35087,17902,17185,11563,5663,5900
52,1,9686000,3,38241,1,6257659,01/01/2022,11.7,42019,21548,20471,12599,6234,6365
53,1,7513000,2,64652,1,4818798,01/01/2022,10.3,22066,11231,10835,6719,3420,3299
54,1,8045000,2,54873,1,5174377,01/01/2022,5.7,17410,9121,8289,6393,3204,3189
55,1,1877000,3,25305,1,1194745,01/01/2022,24,22568,11549,11019,7200,3540,3660
56,1,4487000,3,26105,1,2890445,01/01/2022,6.9,15054,7516,7538,5557,2768,2789
57,1,3184000,2,81669,1,1987931,01/01/2022,8.7,8253,4210,4043,2801,1419,1382
58,1,3835000,2,52412,1,2440338,01/01/2022,7.5,7834,4065,3769,2439,1200,1239
59,1,1654000,3,45311,1,1029789,01/01/2022,4.2,14755,7617,7138,4907,2427,2480
60,1,8914000,3,35981,1,5758119,01/01/2022,7.9,62038,31762,30276,19262,9511,9751
61,2,79819000,1,139571,2,51742779,01/01/2022,15.4,690193,353744,336449,203574,99881,103693
62,3,107273000,1,196113,3,69531337,01/01/2022,12.4,864431,434753,429678,267728,131619,136109
63,2,30054000,2,73555,2,19461545,01/01/2022,14.9,237169,119538,117631,71348,35023,36325
64,2,39533000,2,102265,2,25594185,01/01/2022,14.7,173959,86825,87134,55826,27459,28367
65,1,7361000,3,26507,1,4758143,01/01/2022,12,39058,19755,19303,11201,5479,5722
66,2,93544000,1,227337,2,60576263,01/01/2022,14.2,59762,30506,29256,20025,9931,10094
67,1,11705000,3,41096,1,7567154,01/01/2022,14.2,49490,25496,23994,16916,8460,8456
68,1,22228000,2,59849,1,14388351,01/01/2022,11.8,160225,79799,80426,53549,26489,27060
69,1,13508000,3,18743,1,8761457,01/01/2022,12.3,114010,56192,57818,38156,18905,19251
70,1,20664000,3,45302,1,13386298,01/01/2022,13.8,75242,37695,37547,23792,11778,12014
71,1,9429000,3,27287,1,6101563,01/01/2022,11.8,59196,29915,29281,18125,8949,9176
72,1,12131000,3,30992,1,7854158,01/01/2022,14.1,32704,16713,15991,11320,5572,5748
73,1,4534000,3,25938,1,2921162,01/01/2022,12,23413,11884,11529,7157,3552,3605
74,1,7712000,3,26396,1,4986404,01/01/2022,12.1,38992,19602,19390,13022,6299,6723
75,1,1346000,3,20607,1,854293,01/01/2022,14.4,27314,13703,13611,9005,4397,4608
76,2,50891000,2,70289,2,33008861,01/01/2022,25,146965,75962,71003,46271,22786,23485
77,1,27793000,3,49394,1,18016056,01/01/2022,27.7,88337,44762,43575,34686,17254,17432
78,2,37869000,2,69829,2,24545021,01/01/2022,26.4,159853,80569,79284,57402,28064,29338
79,1,1947000,3,25312,1,1240238,01/01/2022,24.4,9746,4912,4834,3336,1602,1734
80,1,2144000,3,27758,1,1365842,01/01/2022,26.4,15368,7632,7736,5699,2779,2920
81,1,1121000,3,10089,1,718561,01/01/2022,24.1,147496,76348,71148,49524,24280,25244
82,1,979000,3,27667,1,608683,01/01/2022,24.9,14892,7420,7472,5365,2615,2750
83,1,5713000,3,29249,1,3684201,01/01/2022,13.2,34798,17459,17339,10865,5211,5654
84,2,44572000,1,216827,2,28754973,01/01/2022,16,432205,227255,204950,86717,42372,44345
85,2,46833000,1,186534,2,30254916,01/01/2022,16,759003,398068,360935,168014,83097,84917
86,3,104900000,1,340392,3,67844608,01/01/2022,16.5,1173351,609477,563874,261635,129105,132530
87,2,29126000,2,63998,2,18867902,01/01/2022,16.6,414470,219003,195467,75588,37198,38390
88,1,19235000,2,63908,1,12438842,01/01/2022,13.7,186693,97615,89078,46165,22603,23562
89,3,182468000,1,397035,3,118207165,01/01/2022,16.6,1835486,947835,887651,451632,222341,229291
90,2,61015000,1,120642,2,39539108,01/01/2022,16.4,614447,325337,289110,113945,55951,57994
91,1,25394000,2,93867,1,16412233,01/01/2022,16.1,434153,232032,202121,62030,30612,31418
92,2,63081000,1,125281,2,40877369,01/01/2022,13.9,323771,167274,156497,83659,40990,42669
93,2,52431000,2,86753,2,33993397,01/01/2022,13.9,404695,212343,192352,85496,42058,43438
94,1,27479000,1,168944,1,17692406,01/01/2022,15.8,443704,233586,210118,95713,47173,48540
95,2,68120000,1,296497,2,43981503,01/01/2022,14.3,545884,284933,260951,101794,50260,51534
96,1,18292000,2,65619,1,11824181,01/01/2022,14,429481,220393,209088,105785,52018,53767
97,1,11493000,2,53249,1,7417201,01/01/2022,10.9,246428,128767,117661,58169,28791,29378
98,1,12407000,3,28829,1,8035721,01/01/2022,10.9,599935,314284,285651,130174,64060,66114
99,2,98124000,1,180881,2,63599719,01/01/2022,14.4,616068,317266,298802,191866,94056,97810
100,2,60362000,2,84731,2,39150569,01/01/2022,11.9,301742,154079,147663,97495,48007,49488
101,1,7579000,3,21411,1,4904939,01/01/2022,13.6,96243,49040,47203,29383,14345,15038
102,1,14418000,2,65738,1,9305962,01/01/2022,14.8,30063,15334,14729,10450,5151,5299
103,1,1368000,1,106629,1,782571,01/01/2022,22.2,3222,1654,1568,1247,637,610
104,1,10518000,2,80873,1,6755827,01/01/2022,12.2,17967,9205,8762,6003,2945,3058
105,1,1971000,3,23597,1,1257553,01/01/2022,12.5,11943,6311,5632,3854,1993,1861
106,1,1496000,1,106598,1,865802,01/01/2022,15,12850,6538,6312,4678,2267,2411
107,2,30391000,1,115440,2,19638710,01/01/2022,7.7,26678,13733,12945,10032,4897,5135
108,3,201237000,1,280417,3,130523633,01/01/2022,11.5,223876,119352,104524,50306,24928,25378
109,2,68919000,1,195177,2,44602173,01/01/2022,12.3,515353,266081,249272,126007,61695,64312
110,3,105466000,1,371034,3,68181866,01/01/2022,14.1,776220,402522,373698,193769,95439,98330
111,2,68714000,2,100549,2,44563551,01/01/2022,13.5,84298,43745,40553,23019,11356,11663
112,2,52887000,2,64162,2,34312388,01/01/2022,13.3,30929,15848,15081,8319,4034,4285
113,2,35748000,1,124827,2,23111373,01/01/2022,13,293245,152241,141004,70657,34731,35926
114,2,64868000,1,275048,2,41889152,01/01/2022,12.4,658907,338453,320454,150053,73914,76139
115,2,29302000,3,22258,2,19024042,01/01/2022,12.4,117995,60165,57830,29983,14851,15132
116,3,190777000,1,345700,3,123659350,01/01/2022,11.4,1643623,845932,797691,437489,216020,221469
117,2,83267000,1,162480,2,53961070,01/01/2022,15.4,368585,190133,178452,107535,52900,54635
118,2,50434000,2,69545,2,32712555,01/01/2022,6.9,174704,91497,83207,54449,28355,26094
119,1,22090000,3,46174,1,14312326,01/01/2022,4.5,2931,1520,1411,975,512,463
120,2,64939000,1,130412,2,42079938,01/01/2022,7.7,35491,18986,16505,7987,3993,3994
121,2,70839000,1,152967,2,45892383,01/01/2022,13.5,703215,359601,343614,230612,113552,117060
122,2,67180000,1,191237,2,43475763,01/01/2022,14.4,18226,9300,8926,5308,2603,2705
123,2,54549000,2,58446,2,35398404,01/01/2022,13.5,1072676,556998,515678,265425,131078,134347
124,1,24034000,3,21650,1,15600450,01/01/2022,19.2,14038,7254,6784,3763,1910,1853
125,2,79798000,2,86626,2,51782074,01/01/2022,6.9,174704,91497,83207,54449,28355,26094
126,2,52401000,3,37911,2,34022739,01/01/2022,11.5,7077,3593,3484,1748,893,855
127,2,42983000,2,59546,2,27879404,01/01/2022,12.5,53362,27304,26058,15169,7515,7654
128,1,20876000,3,21053,1,13548347,01/01/2022,3.3,24612,12254,12358,7339,3541,3798
129,2,53722000,1,193821,2,34725479,01/01/2022,14,10873,5623,5250,3757,1878,1879
130,2,58804000,2,64867,2,38157733,01/01/2022,10.2,23219,12339,10880,6425,3186,3239
131,1,26460000,3,30082,1,17168918,01/01/2022,14.4,12671,6512,6159,3454,1710,1744
132,1,22280000,3,34945,1,14447055,01/01/2022,10.6,30967,16277,14690,10756,5327,5429
133,2,47177000,2,60633,2,30604417,01/01/2022,15.5,323545,166328,157217,93932,46757,47175
134,1,7139000,3,21125,1,4619225,01/01/2022,20.4,19326,10155,9171,6252,3129,3123
135,1,24827000,3,38451,1,16099099,01/01/2022,6.9,33716,17686,16030,9317,4624,4693
136,1,15317000,2,55865,1,9900185,01/01/2022,12.2,40279,20716,19563,10282,5078,5204
137,1,3971000,3,23878,1,2557272,01/01/2022,13.3,29068,14916,14152,8580,4220,4360
138,2,32942000,2,63873,2,21348427,01/01/2022,14.6,12752,6694,6058,3471,1768,1703
139,1,4910000,2,54807,1,3136693,01/01/2022,11.3,33166,16973,16193,9497,4707,4790
140,1,7516000,3,11280,1,4874120,01/01/2022,12.4,52828,27143,25685,16500,8128,8372
141,2,35479000,3,27948,2,23033402,01/01/2022,13,32738,16941,15797,9059,4431,4628
142,1,13320000,3,28211,1,8629789,01/01/2022,13.3,30203,15792,14411,7568,3777,3791
143,2,33836000,3,40209,2,21953191,01/01/2022,12.4,11760,6069,5691,3432,1700,1732
144,1,12871000,3,20978,1,8345172,01/01/2022,13.5,72525,37076,35449,22128,10944,11184
145,1,9462000,3,29526,1,6120774,01/01/2022,4.5,18580,9729,8851,5724,2801,2923
146,1,22420000,3,32506,1,14540494,01/01/2022,14.4,24575,12798,11777,7126,3453,3673
147,1,1357000,3,23070,1,858980,01/01/2022,13,44731,22925,21806,13335,6514,6821
148,1,8807000,2,60099,1,5664451,01/01/2022,12.3,658907,338453,320454,150053,73914,76139
149,1,14444000,3,31505,1,9357095,01/01/2022,14.2,10336,5387,4949,3449,1664,1785
150,1,11486000,3,23479,1,7442421,01/01/2022,12,4656,2421,2235,1533,751,782
151,1,8483000,3,29607,1,5484343,01/01/2022,15.5,9598,5002,4596,2910,1467,1443
152,1,11029000,3,20276,1,7148574,01/01/2022,12.4,15171,7853,7318,4470,2251,2219
153,1,6581000,3,27414,1,4250236,01/01/2022,13.3,10792,5577,5215,3492,1713,1779
154,1,2142000,3,3568,1,1388732,01/01/2022,12.4,37442,19141,18301,12089,5963,6126
155,1,4700000,3,29290,1,3025710,01/01/2022,6.9,17736,9182,8554,5577,2775,2802
156,1,9397000,3,10498,1,6097552,01/01/2022,14.4,386290,199249,187041,112223,55337,56886
157,1,9800000,3,32888,1,6337112,01/01/2022,14.4,9925,5218,4707,2833,1403,1430
158,1,10279000,3,27488,1,6653862,01/01/2022,19.2,6944,3666,3278,2341,1149,1192
159,1,7661000,3,2021,1,4977629,01/01/2022,11.4,88734,45471,43263,28316,14166,14150
160,1,9982000,3,21835,1,6466465,01/01/2022,7.7,6449,3346,3103,1687,833,854
161,1,6236000,3,19313,1,4034087,01/01/2022,11.1,10735,5576,5159,3010,1518,1492
162,1,2416000,3,21892,1,1548508,01/01/2022,7.7,10810,5614,5196,2941,1451,1490
165,3,200310000,1,250772,3,129950728,01/01/2022,18.3,1579803,804212,775591,594938,292494,302444
166,2,85049000,2,72027,2,55209823,01/01/2022,14.5,378143,194849,183294,128863,62806,66057
167,2,77325000,2,73964,2,50187286,01/01/2022,16.6,452090,230346,221744,162764,80177,82587
168,1,24814000,3,40945,1,16088155,01/01/2022,16.8,69371,35473,33898,25304,12303,13001
169,2,33123000,2,54119,2,21475831,01/01/2022,16.1,79772,40908,38864,30907,15312,15595
170,1,28170000,3,39456,1,18271044,01/01/2022,16.6,56597,29703,26894,19146,9514,9632
171,1,24710000,3,35948,1,16025552,01/01/2022,14.8,72663,38036,34627,27395,13712,13683
172,2,49171000,2,89632,2,31871518,01/01/2022,16.7,160682,83178,77504,52342,25860,26482
173,2,32851000,3,39775,2,21313375,01/01/2022,15.6,83352,42766,40586,32937,16375,16562
174,2,34862000,3,37088,2,22623212,01/01/2022,13.8,67101,35567,31534,27008,13393,13615
175,1,20419000,3,32936,1,13239414,01/01/2022,17.1,43249,22352,20897,17065,8284,8781
176,1,26768000,2,58921,1,17340279,01/01/2022,14.7,51894,27702,24192,20579,10113,10466
177,1,24569000,2,54912,1,15914938,01/01/2022,16.1,70068,36526,33542,21044,10402,10642
178,1,25075000,3,29775,1,16268975,01/01/2022,16.8,52156,27081,25075,17108,8394,8714
179,1,3991000,3,28857,1,2565293,01/01/2022,20.6,41910,21741,20169,12631,6146,6485
180,1,23695000,2,55094,1,15346656,01/01/2022,15.4,43998,23109,20889,17575,8775,8800
181,1,4839000,3,29156,1,3116194,01/01/2022,18.2,24757,12827,11930,9816,4898,4918
182,1,4278000,3,22712,1,2757988,01/01/2022,16.1,21756,11234,10522,8659,4317,4342
183,1,9508000,3,10500,1,6169700,01/01/2022,15.4,28109,14419,13690,10548,5187,5361
184,1,7044000,3,27253,1,4551347,01/01/2022,19.5,15305,7996,7309,5899,2872,3027
185,1,28662000,3,41799,1,18588501,01/01/2022,14.4,72452,38019,34433,23628,11618,12010
186,1,22756000,3,27636,1,14763764,01/01/2022,16.4,35401,18444,16957,12235,5945,6290
187,1,27906000,2,55802,1,18083098,01/01/2022,14.9,27593,14289,13304,10803,5260,5543
188,1,21804000,3,25704,1,14146896,01/01/2022,16.8,31264,16171,15093,9806,4840,4966
189,1,21395000,2,54794,1,13851956,01/01/2022,13.2,24228,12861,11367,9383,4674,4709
190,1,20627000,3,29385,1,13378165,01/01/2022,11.3,32831,17049,15782,13856,6706,7150
191,1,2470000,3,26445,1,1579055,01/01/2022,16.7,16092,8507,7585,6837,3451,3386
192,1,9675000,3,32104,1,6256646,01/01/2022,16,8011,4268,3743,3134,1562,1572
193,1,16460000,3,28167,1,10670833,01/01/2022,18.2,29002,14796,14206,11206,5550,5656
194,1,3144000,3,30705,1,2012895,01/01/2022,13.4,7946,4172,3774,3293,1607,1686
195,1,12615000,3,10590,1,8189160,01/01/2022,17.8,28260,14728,13532,11002,5473,5529
196,1,7079000,3,5361,1,4595989,01/01/2022,15.6,25845,13471,12374,9370,4627,4743
197,3,142268000,1,193869,3,92280331,01/01/2022,24.9,658609,345979,312630,183298,90145,93153
198,2,53394000,2,64417,2,34641683,01/01/2022,21,225728,119129,106599,71494,35347,36147
199,2,34743000,3,48018,2,22534932,01/01/2022,29.8,70760,36613,34147,21788,10705,11083
200,2,43204000,2,89325,2,27993275,01/01/2022,24.1,132854,69610,63244,41183,20301,20882
201,1,19085000,2,63781,1,12341469,01/01/2022,19.7,50399,26542,23857,14000,6918,7082
202,1,2499000,3,29598,1,1594752,01/01/2022,22.6,27944,14419,13525,9490,4664,4826
203,1,5206000,3,30886,1,3353014,01/01/2022,15.9,22534,11802,10732,7926,3939,3987
204,1,14685000,3,30091,1,9515159,01/01/2022,25.6,25148,13436,11712,8928,4476,4452
205,1,22698000,3,30006,1,14723694,01/01/2022,18.4,33783,18241,15542,12201,6089,6112
206,2,31638000,3,32646,2,20532054,01/01/2022,26.2,25850,13268,12582,8390,4048,4342
208,2,31317000,3,47275,2,20308775,01/01/2022,19,27607,14605,13002,9883,5002,4881
209,1,9806000,3,30006,1,6343894,01/01/2022,25.4,13866,7187,6679,4383,2099,2284
210,1,7395000,3,29607,1,4777143,01/01/2022,27.1,23363,12127,11236,7776,3818,3958
211,1,15654000,3,36370,1,10138730,01/01/2022,24.8,18224,9500,8724,7072,3514,3558
212,1,14694000,3,28197,1,9522903,01/01/2022,27,16447,8464,7983,4843,2381,2462
213,1,6806000,3,7279,1,4416621,01/01/2022,20.9,17550,9283,8267,5700,2861,2839
214,2,77238000,1,176203,2,50028497,01/01/2022,14,297848,156299,141549,74787,37046,37741
215,2,29837000,3,31773,2,19362277,01/01/2022,15.2,29390,15521,13869,7939,3942,3997
216,2,33390000,2,91639,2,21611861,01/01/2022,15.1,37608,20094,17514,11115,5490,5625
217,2,39261000,2,75961,2,25443689,01/01/2022,14.9,106163,56161,50002,30752,15034,15718
218,1,13934000,3,27608,1,9029492,01/01/2022,13.4,11149,5894,5255,2996,1479,1517
219,2,39220000,2,58008,2,25434992,01/01/2022,11.2,60265,30945,29320,18808,9224,9584
220,1,21975000,3,34199,1,14249551,01/01/2022,15.6,17718,9411,8307,4913,2492,2421
221,1,20189000,2,54429,1,13068421,01/01/2022,15.2,36618,19077,17541,10530,5273,5257
222,1,13032000,3,25412,1,8445388,01/01/2022,15.8,9853,5224,4629,2757,1390,1367
223,1,2442000,3,30087,1,1557213,01/01/2022,15.2,27713,14561,13152,7736,3885,3851
224,1,6369000,3,27411,1,4112439,01/01/2022,14.1,32276,17014,15262,9457,4578,4879
225,1,9709000,3,27333,1,6283517,01/01/2022,15.8,14689,7582,7107,4123,2033,2090
226,2,36998000,2,65341,2,23983359,01/01/2022,22,44311,23331,20980,13756,6771,6985
227,1,4244000,3,29038,1,2729562,01/01/2022,17.9,14732,7791,6941,4911,2433,2478
228,1,13195000,3,27728,1,8549022,01/01/2022,14.3,20530,10890,9640,6356,3180,3176
229,1,14274000,3,25305,1,9252795,01/01/2022,19,16368,8558,7810,4728,2323,2405
230,1,9550000,3,24947,1,6182553,01/01/2022,11.8,6213,3216,2997,1786,871,915
231,1,12463000,3,24825,1,8076125,01/01/2022,11.2,28792,15288,13504,8327,4111,4216
233,1,5316000,3,4908,1,3450492,01/01/2022,15.7,8657,4501,4156,2464,1200,1264
234,2,58891000,1,120932,2,38158218,01/01/2022,22.1,224166,112147,112019,65088,31954,33134
235,1,25008000,2,88961,1,16166239,01/01/2022,15.3,111569,57370,54199,36412,17892,18520
236,1,28916000,3,37736,1,18757664,01/01/2022,17.4,38780,20122,18658,13025,6461,6564
237,3,120485000,1,371500,3,77943750,01/01/2022,17.7,1385621,718628,666993,333198,164217,168981
238,2,84801000,1,270389,2,54850261,01/01/2022,16.5,1257547,645398,612149,321993,158559,163434
239,1,18868000,3,36266,1,12227934,01/01/2022,17.5,37871,19554,18317,11359,5732,5627
240,2,69164000,1,220962,2,44735638,01/01/2022,19.6,650123,329365,320758,200033,98558,101475
241,2,35095000,2,77573,2,22734177,01/01/2022,18.5,111975,57735,54240,31481,15460,16021
242,1,12231000,3,25344,1,7924806,01/01/2022,17.4,98842,50427,48415,30938,15263,15675
243,2,52469000,1,206538,2,33898312,01/01/2022,16.6,44103,22420,21683,15768,7755,8013
244,1,8788000,3,32129,1,5680071,01/01/2022,14.1,53539,27205,26334,18000,8916,9084
245,1,10134000,3,23864,1,6563236,01/01/2022,27,18787,9476,9311,6502,3270,3232
246,1,14013000,3,38425,1,9070025,01/01/2022,17.4,59648,30609,29039,19344,9536,9808
247,2,51736000,1,113728,2,33514672,01/01/2022,18.5,30471,15635,14836,9610,4654,4956
248,1,3390000,3,29348,1,2174152,01/01/2022,17.2,20286,10307,9979,6804,3413,3391
249,1,3495000,3,25995,1,2245755,01/01/2022,17.2,20345,10131,10214,6733,3300,3433
250,1,16492000,3,44289,1,10675511,01/01/2022,17.2,31115,15891,15224,10525,5240,5285
251,1,11993000,2,52118,1,7743332,01/01/2022,17.2,16550,8456,8094,5252,2552,2700
252,1,12413000,3,28459,1,8039991,01/01/2022,19.1,24352,12627,11725,8092,4062,4030
253,1,18967000,3,41432,1,12287118,01/01/2022,15.2,94978,48709,46269,29794,14672,15122
254,1,21135000,3,30624,1,13707126,01/01/2022,21.8,52019,26739,25280,15725,7759,7966
255,1,3494000,3,27017,1,2244083,01/01/2022,16.5,24580,12765,11815,8215,4057,4158
256,1,11107000,3,30925,1,7188625,01/01/2022,17.2,28678,14679,13999,9074,4497,4577
257,1,3767000,3,26712,1,2421838,01/01/2022,13.9,22738,11719,11019,7000,3537,3463
258,1,9080000,3,27199,1,5874801,01/01/2022,18.5,28145,14670,13475,8863,4390,4473
259,1,7141000,3,32798,1,4608852,01/01/2022,18.5,19113,9852,9261,5504,2716,2788
260,1,1844000,3,27145,1,1171455,01/01/2022,14.1,25925,13382,12543,8585,4189,4396
261,1,767000,3,26445,1,472105,01/01/2022,17.2,13033,6697,6336,4420,2181,2239
262,1,2922000,3,25839,1,1873461,01/01/2022,8.6,5955,3118,2837,1972,974,998
263,1,1672000,3,23370,1,1063430,01/01/2022,17.2,8850,4524,4326,2773,1377,1396
264,1,2003000,3,24605,1,1277345,01/01/2022,13.9,9529,4943,4586,3018,1490,1528
265,1,7678000,3,30548,1,4960152,01/01/2022,14.1,14636,7533,7103,4910,2424,2486
266,1,13795000,3,39336,1,8927414,01/01/2022,17.2,40906,20800,20106,12864,6409,6455
267,1,6713000,3,29549,1,4333901,01/01/2022,18.5,8142,4289,3853,2686,1333,1353
268,1,2004000,3,25995,1,1276605,01/01/2022,13.9,7954,4060,3894,2570,1274,1296
269,1,8923000,3,28689,1,5771261,01/01/2022,17.2,17000,8527,8473,5215,2549,2666
270,1,3582000,3,26046,1,2302254,01/01/2022,15.5,14424,7439,6985,5399,2678,2721
271,1,1985000,3,26987,1,1263263,01/01/2022,17.2,16873,8725,8148,6022,3008,3014
272,1,2437000,3,20848,1,1563202,01/01/2022,18.5,5109,2618,2491,1631,805,826
273,1,2070000,3,26977,1,1318523,01/01/2022,18.5,13243,6795,6448,4043,1954,2089
274,1,2188000,3,25166,1,1397034,01/01/2022,14.1,14497,7627,6870,4260,2099,2161
275,1,1834000,3,22438,1,1169662,01/01/2022,18.4,16324,8373,7951,5562,2774,2788
276,1,5001000,3,29058,1,3221592,01/01/2022,25.1,9842,5047,4795,3323,1629,1694
277,1,2780000,3,25419,1,1781581,01/01/2022,14.1,27833,14525,13308,9097,4581,4516
278,1,3562000,3,5013,1,2310287,01/01/2022,18.5,33284,17172,16112,10804,5349,5455
279,1,1578000,3,25440,1,1000260,01/01/2022,22.3,14697,7601,7096,4740,2380,2360
280,1,3266000,3,20998,1,2101902,01/01/2022,15.2,18607,9363,9244,6403,3178,3225
284,3,117476000,1,201159,3,76158241,01/01/2022,19,743275,388114,355161,202467,99875,102592
285,2,41963000,2,104743,2,27171207,01/01/2022,16.6,154546,80401,74145,48513,24003,24510
286,2,72621000,2,102656,2,47100994,01/01/2022,16.7,299523,155411,144112,93845,46362,47483
287,2,45752000,2,71989,2,29666811,01/01/2022,26.3,83637,42325,41312,24783,12286,12497
288,2,42801000,2,91410,2,27729240,01/01/2022,26,102362,52461,49901,35162,17416,17746
289,1,19146000,3,38825,1,12406075,01/01/2022,14.1,55287,28877,26410,16959,8447,8512
290,1,24274000,3,42309,1,15735791,01/01/2022,18.6,87042,45232,41810,26414,12958,13456
291,2,39595000,2,64899,2,25671851,01/01/2022,9.5,86901,45620,41281,26262,13160,13102
292,1,24637000,3,26468,1,15987582,01/01/2022,17.2,30519,15931,14588,10809,5325,5484
293,2,36847000,3,39389,2,23911161,01/01/2022,14.1,60811,31893,28918,19713,9706,10007
294,1,4464000,3,10909,1,2890691,01/01/2022,13.2,61510,31765,29745,21000,10487,10513
295,1,25524000,2,55867,1,16534733,01/01/2022,16.2,70042,36241,33801,21818,10809,11009
296,1,5729000,3,11047,1,3712803,01/01/2022,17.7,24662,12965,11697,6937,3350,3587
297,1,6804000,3,23336,1,4399264,01/01/2022,13.2,15414,7999,7415,4635,2291,2344
298,1,25816000,3,28457,1,16751943,01/01/2022,14.7,71528,37497,34031,23278,11539,11739
299,1,2275000,3,27648,1,1451102,01/01/2022,17.2,15249,7932,7317,4894,2453,2441
300,2,30161000,3,27795,2,19576855,01/01/2022,15.2,39425,20578,18847,13203,6477,6726
301,1,3187000,3,29067,1,2042483,01/01/2022,17.7,17293,8766,8527,5650,2795,2855
302,1,14517000,3,28465,1,9407585,01/01/2022,9.5,16905,8772,8133,5514,2740,2774
303,1,4018000,3,26313,1,2585387,01/01/2022,14.1,18097,9360,8737,5881,2892,2989
304,1,15679000,3,27795,1,10163555,01/01/2022,17.3,32333,16690,15643,10314,5057,5257
305,1,20090000,3,30006,1,13028494,01/01/2022,16.1,49940,25545,24395,16071,7998,8073
306,1,16132000,3,30054,1,10455746,01/01/2022,16,1049,546,503,282,149,133
307,1,16710000,3,28457,1,10833043,01/01/2022,16.7,6853,3584,3269,2311,1149,1162
308,1,8046000,3,5405,1,5224495,01/01/2022,24.9,12262,6119,6143,4251,2104,2147
309,1,2657000,3,44049,1,1683001,01/01/2022,16.1,11086,5609,5477,3615,1780,1835
311,2,55038000,1,158231,2,35616469,01/01/2022,20.5,341029,180370,160659,82444,40670,41774
312,2,73091000,2,91723,2,47417427,01/01/2022,20.2,157336,82380,74956,43883,21497,22386
313,1,22686000,3,10570,1,14735330,01/01/2022,23.2,174629,91268,83361,46521,22880,23641
314,2,33937000,3,50586,2,22008464,01/01/2022,22,104461,54150,50311,30967,15315,15652
315,1,17096000,2,55505,1,11056895,01/01/2022,20.1,44353,23038,21315,13070,6400,6670
316,1,4597000,3,29464,1,2958586,01/01/2022,23,21375,11206,10169,5662,2753,2909
317,2,35073000,3,45189,2,22752261,01/01/2022,24,17777,9225,8552,4254,2086,2168
318,2,40534000,1,105753,2,26241347,01/01/2022,23.2,64084,32934,31150,19785,9668,10117
319,1,17009000,3,31232,1,11024618,01/01/2022,21.8,20434,10867,9567,5939,2970,2969
320,1,16482000,3,27253,1,10686047,01/01/2022,16.8,19085,9763,9322,6343,3119,3224
321,2,79115000,1,131475,2,51293275,01/01/2022,17.9,371387,192530,178857,106784,52432,54352
322,1,19726000,3,25457,1,12796443,01/01/2022,22.4,18023,9240,8783,5154,2503,2651
323,1,11994000,3,50812,1,7745288,01/01/2022,19.5,20322,10479,9843,6201,3025,3176
324,1,16440000,3,33564,1,10652436,01/01/2022,19.5,25477,13300,12177,8208,4059,4149
325,1,8477000,2,69968,1,5440082,01/01/2022,22.4,13620,7015,6605,4098,1994,2104
326,1,10792000,3,28196,1,6986604,01/01/2022,19.5,48170,25016,23154,15515,7657,7858
327,1,4358000,3,28799,1,2803901,01/01/2022,24.7,10593,5340,5253,3485,1705,1780
328,2,35247000,2,83997,2,22826553,01/01/2022,22.4,8730,4395,4335,2894,1447,1447
329,1,3982000,3,27411,1,2560889,01/01/2022,24.7,14678,7367,7311,4863,2405,2458
330,1,6772000,3,26803,1,4374997,01/01/2022,22.4,10935,5450,5485,3532,1706,1826
331,1,8991000,3,25872,1,5818278,01/01/2022,22.8,19976,10345,9631,6431,3120,3311
332,2,42836000,1,108454,2,27734946,01/01/2022,13.4,412199,209241,202958,82879,40585,42294
333,2,42643000,1,145534,2,27572416,01/01/2022,14.9,304052,152635,151417,84118,41457,42661
334,2,67512000,1,151627,2,43731173,01/01/2022,12.5,536436,267279,269157,158598,77797,80801
335,2,90273000,1,153984,2,58523466,01/01/2022,12.5,635862,320627,315235,153834,75737,78097
336,3,105816000,1,236361,3,68544039,01/01/2022,12.1,1142952,578172,564780,270109,132170,137939
338,1,12130000,2,52910,1,7831590,01/01/2022,12.5,75721,38037,37684,21903,10795,11108
339,1,14225000,3,36886,1,9209364,01/01/2022,14.1,70378,35870,34508,21367,10464,10903
340,2,34272000,3,26592,2,22250208,01/01/2022,10.7,308285,152976,155309,108145,53196,54949
342,2,30256000,2,72329,2,19594071,01/01/2022,13,234698,115478,119220,87040,43098,43942
343,1,8979000,3,31959,1,5804391,01/01/2022,12.5,28843,14318,14525,8529,4190,4339
344,1,9710000,3,29494,1,6282006,01/01/2022,15.5,33522,17126,16396,9330,4711,4619
345,1,11998000,2,54195,1,7744505,01/01/2022,13.3,54467,27606,26861,15858,7789,8069
346,1,11830000,3,23136,1,7666364,01/01/2022,13.4,13059,6525,6534,4137,2073,2064
347,1,922000,3,4466,1,594834,01/01/2022,10.7,9934,4952,4982,3082,1558,1524
348,1,4156000,3,29902,1,2671498,01/01/2022,10.7,7844,4131,3713,2621,1355,1266
349,1,7189000,2,56222,1,4616628,01/01/2022,12.5,48069,23121,24948,16392,8040,8352
350,1,7553000,3,25880,1,4883570,01/01/2022,14.9,11583,5810,5773,3713,1872,1841
351,1,4578000,3,23812,1,2951888,01/01/2022,23.1,29903,15539,14364,9778,4798,4980
352,3,137661000,1,284035,3,89195615,01/01/2022,20.8,258913,138803,120110,68042,33683,34359
353,2,48498000,2,89815,2,31433885,01/01/2022,22.6,103609,54904,48705,31555,15575,15980
354,1,25847000,2,78856,1,16721694,01/01/2022,27,76660,40113,36547,21596,10646,10950
355,2,35566000,2,56932,2,23060968,01/01/2022,27.6,88280,46038,42242,25864,12608,13256
356,2,30252000,2,64838,2,19598962,01/01/2022,18.3,56163,29689,26474,18214,8872,9342
357,1,2225000,3,33897,1,1412353,01/01/2022,22.6,7263,3837,3426,2540,1279,1261
358,1,16109000,3,26288,1,10444562,01/01/2022,26.1,16645,8759,7886,5075,2484,2591
359,1,13018000,2,58076,1,8403624,01/01/2022,21.2,31469,16729,14740,9837,4899,4938
360,1,14244000,3,26415,1,9232185,01/01/2022,13.6,12729,6935,5794,4541,2296,2245
361,1,12023000,3,28998,1,7785952,01/01/2022,27.6,26015,13735,12280,7360,3633,3727
362,2,41449000,3,31795,2,26910055,01/01/2022,23.1,29903,15539,14364,9778,4798,4980
363,1,25015000,2,59634,1,16200116,01/01/2022,26.4,10504,5405,5099,3440,1722,1718
364,1,16087000,3,27526,1,10429024,01/01/2022,27.3,45134,23442,21692,13494,6690,6804
365,1,20200000,2,55044,1,13074956,01/01/2022,17.9,29130,15431,13699,9957,5019,4938
366,1,4356000,3,21479,1,2809921,01/01/2022,21.4,5812,3105,2707,1767,906,861
367,1,14484000,3,27845,1,9386755,01/01/2022,13.6,15851,8463,7388,5625,2839,2786
368,1,4655000,3,27295,1,2998455,01/01/2022,17.9,15298,8185,7113,4499,2268,2231
369,1,24747000,3,32261,1,16053289,01/01/2022,27.6,17525,9370,8155,5075,2488,2587
370,1,18973000,2,81842,1,12250608,01/01/2022,13.6,18915,10248,8667,6395,3217,3178
371,1,21306000,3,23843,1,13825057,01/01/2022,19.2,81848,43535,38313,23849,11894,11955
372,2,35631000,3,40010,2,23120140,01/01/2022,19.3,33726,17513,16213,11096,5372,5724
373,1,1959000,3,23070,1,1250280,01/01/2022,17.9,11168,5931,5237,3889,1954,1935
374,1,5338000,3,27259,1,3442441,01/01/2022,22.6,6341,3343,2998,2049,979,1070
375,1,21602000,3,15411,1,14025889,01/01/2022,19.2,45895,23816,22079,12162,5997,6165
376,1,5658000,3,31555,1,3646145,01/01/2022,22.1,6863,3664,3199,2612,1321,1291
377,1,11164000,3,27945,1,7228655,01/01/2022,19.3,10611,5602,5009,3876,1871,2005
378,1,3015000,3,28799,1,1930951,01/01/2022,26.1,14226,7514,6712,4380,2214,2166
379,1,4553000,3,23606,1,2935844,01/01/2022,19.2,7997,4114,3883,2359,1161,1198
380,1,3819000,3,10989,1,2471361,01/01/2022,21.2,4188,2243,1945,1509,761,748
381,1,26315000,2,66288,1,17038462,01/01/2022,23.1,15373,8115,7258,5203,2638,2565
382,1,15813000,3,26629,1,10251821,01/01/2022,27.2,14071,7408,6663,4497,2251,2246
383,1,1875000,3,23596,1,1195154,01/01/2022,14,6642,3720,2922,2058,1005,1053
384,1,5916000,3,49833,1,3795567,01/01/2022,26.2,11054,5638,5416,3563,1745,1818
385,3,236294000,1,457589,3,153133511,01/01/2022,15.6,1542232,806262,735970,402209,198130,204079
386,2,53790000,2,66075,2,34897425,01/01/2022,13.1,78264,40929,37335,23163,11368,11795
387,2,65573000,2,82193,2,42540257,01/01/2022,15.9,293825,155300,138525,93203,46206,46997
388,1,28191000,3,49076,1,18275074,01/01/2022,21.2,49578,26095,23483,16381,8171,8210
389,2,36545000,3,45210,2,23709040,01/01/2022,17.1,89314,47398,41916,25892,12760,13132
390,2,47734000,3,38046,2,30989054,01/01/2022,14.8,31315,16320,14995,10348,5100,5248
391,1,20364000,2,54586,1,13182014,01/01/2022,11.5,39203,20881,18322,12964,6446,6518
392,1,21971000,2,55271,1,14225879,01/01/2022,14.1,58957,31503,27454,19229,9506,9723
393,2,38972000,2,92511,2,25239289,01/01/2022,12.3,62849,33939,28910,17954,8876,9078
394,1,20970000,3,40654,1,13589846,01/01/2022,12.6,25468,13582,11886,8293,4136,4157
395,1,24456000,3,51987,1,15844413,01/01/2022,11.5,31599,16595,15004,11708,5967,5741
396,1,28991000,2,73316,1,18770834,01/01/2022,11.5,29123,15247,13876,9589,4733,4856
397,1,18904000,3,28255,1,12259345,01/01/2022,14.2,18110,9443,8667,6325,3046,3279
398,1,12314000,3,44304,1,7959796,01/01/2022,11.5,31695,16422,15273,11280,5582,5698
399,1,18454000,3,37414,1,11957686,01/01/2022,11.5,95322,48884,46438,32521,16133,16388
400,1,16957000,3,30698,1,10991352,01/01/2022,11.5,9358,5013,4345,2738,1323,1415
401,1,13282000,2,55288,1,8578012,01/01/2022,13.2,9149,4948,4201,2691,1357,1334
402,1,3485000,3,26445,1,2238805,01/01/2022,11.5,9913,5282,4631,3496,1711,1785
403,1,11640000,3,10071,1,7555929,01/01/2022,11.5,36620,18819,17801,10303,4961,5342
404,1,1968000,3,47221,1,1231979,01/01/2022,11.5,5276,2719,2557,1830,893,937
405,1,18547000,3,30013,1,12025537,01/01/2022,11.5,41455,21994,19461,13993,6843,7150
406,1,18277000,3,27803,1,11852247,01/01/2022,13.2,29613,15403,14210,9414,4672,4742
408,1,12053000,3,40392,1,7794058,01/01/2022,13.9,13922,7166,6756,5211,2590,2621
409,1,3709000,3,24604,1,2386246,01/01/2022,11.5,10960,5789,5171,3556,1785,1771
410,1,13817000,3,30006,1,8951044,01/01/2022,9.9,22904,12086,10818,7644,3743,3901
411,1,8484000,3,26404,1,5488196,01/01/2022,11.5,11776,6077,5699,3730,1832,1898
412,1,1953000,3,9781,1,1259669,01/01/2022,11.5,16797,8560,8237,5425,2652,2773
413,1,3493000,3,26445,1,2244005,01/01/2022,11.5,19648,10052,9596,6751,3334,3417
414,1,16821000,3,30698,1,10902952,01/01/2022,20.6,19341,10302,9039,6428,3158,3270
415,1,3047000,3,28050,1,1952500,01/01/2022,13.7,11487,6208,5279,3749,1855,1894
416,1,4773000,3,20303,1,3082147,01/01/2022,11.5,5703,2985,2718,1959,971,988
417,1,2215000,3,23206,1,1416544,01/01/2022,11.5,6644,3435,3209,2305,1130,1175
418,1,2778000,3,16777,1,1788923,01/01/2022,11.5,7491,3982,3509,2583,1266,1317
419,1,1910000,3,13778,1,1227722,01/01/2022,11.5,8481,4360,4121,2849,1391,1458
420,1,24232000,3,38527,1,15712273,01/01/2022,15,46996,24240,22756,12187,6012,6175
421,1,2417000,3,23597,1,1547453,01/01/2022,17.4,8445,4468,3977,3005,1505,1500
422,1,6016000,3,24946,1,3885454,01/01/2022,13.7,5612,3027,2585,1851,938,913
423,1,7946000,3,26504,1,5138396,01/01/2022,21.4,5276,2719,2557,1830,893,937
424,3,191347000,1,259867,3,124115683,01/01/2022,16.7,794789,407239,387550,199480,98049,101431
425,2,46952000,2,65931,2,30452869,01/01/2022,13.8,177719,91525,86194,50219,24680,25539
426,1,21687000,3,29563,1,14066987,01/01/2022,13.8,34955,18206,16749,9854,4805,5049
427,1,1971000,3,24497,1,1256653,01/01/2022,13.6,115264,60166,55098,28758,14392,14366
428,1,17117000,3,26854,1,11099196,01/01/2022,13.8,16795,8697,8098,5436,2628,2808
429,1,6313000,3,26313,1,4077137,01/01/2022,16.3,13390,6831,6559,4033,1966,2067
430,1,8309000,3,27561,1,5373289,01/01/2022,16.3,7953,4224,3729,2375,1195,1180
431,1,8926000,3,20739,1,5781161,01/01/2022,18.7,15512,8121,7391,5093,2493,2600
432,2,47218000,2,52025,2,30639675,01/01/2022,25.1,169028,86790,82238,45879,22689,23190
433,3,136162000,1,170364,3,88334936,01/01/2022,25.2,888797,441181,447616,247410,121384,126026
434,2,66337000,2,81647,2,43037403,01/01/2022,22.4,304942,149380,155562,85665,42398,43267
435,1,19786000,2,59380,1,12801520,01/01/2022,25.2,84519,42292,42227,24955,12440,12515
436,1,15149000,3,25305,1,9821545,01/01/2022,23.2,30754,15948,14806,10320,5221,5099
437,3,108766000,1,144090,3,70553810,01/01/2022,14.1,845941,437370,408571,227808,112567,115241
438,2,46318000,2,68789,2,30037911,01/01/2022,19.2,136351,71718,64633,38918,19062,19856
439,1,24105000,2,74142,1,15594108,01/01/2022,15,86686,44901,41785,27406,13467,13939
440,2,30092000,2,52594,2,19507206,01/01/2022,17.4,58158,30570,27588,17715,8934,8781
441,1,25259000,2,89333,1,16329017,01/01/2022,19.3,24258,12834,11424,7258,3602,3656
442,1,9681000,3,30548,1,6262102,01/01/2022,19.2,24454,12691,11763,7326,3576,3750
443,1,17748000,3,32742,1,11503458,01/01/2022,14.1,310192,159130,151062,94872,46787,48085
444,1,2455000,3,29526,1,1566224,01/01/2022,15.7,14340,7646,6694,4731,2430,2301
445,2,54924000,2,81038,2,35619562,01/01/2022,19.2,15341,8078,7263,4842,2416,2426
446,1,3860000,3,29607,1,2479393,01/01/2022,19.3,8045,4283,3762,2501,1247,1254
447,1,8618000,3,26937,1,5574763,01/01/2022,19.3,6644,3540,3104,2086,1058,1028
448,1,3134000,3,24263,1,2012837,01/01/2022,19.2,16582,8647,7935,5030,2477,2553
449,1,19740000,2,75765,1,12755235,01/01/2022,21.2,30796,15740,15056,9239,4503,4736
450,2,51232000,2,88897,2,33211903,01/01/2022,19.9,77849,40866,36983,21990,10871,11119
451,1,25344000,3,42912,1,16430688,01/01/2022,21.1,65215,33971,31244,19700,9733,9967
452,2,91831000,1,153826,2,59536324,01/01/2022,20.9,441975,227109,214866,122010,60145,61865
453,3,207438000,1,267978,3,134566722,01/01/2022,22.1,808416,416251,392165,234633,115277,119356
454,2,67116000,1,152201,2,43473199,01/01/2022,19.7,298009,154344,143665,83869,41238,42631
455,1,12227000,3,25621,1,7921929,01/01/2022,25,33924,17240,16684,10629,5267,5362
456,1,10065000,3,35609,1,6506641,01/01/2022,19.7,14772,7516,7256,4444,2199,2245
457,1,17147000,3,36920,1,11108630,01/01/2022,21.2,19742,9908,9834,6831,3367,3464
458,1,8656000,3,31514,1,5594886,01/01/2022,19.7,12848,6693,6155,3711,1831,1880
459,1,8507000,3,47577,1,5481973,01/01/2022,20.4,5457,2839,2618,1473,755,718
460,1,4923000,3,31100,1,3168850,01/01/2022,20.5,5926,3043,2883,1700,842,858
461,1,8417000,3,30149,1,5440901,01/01/2022,25,17097,8801,8296,5359,2662,2697
462,1,12744000,2,58714,1,8224886,01/01/2022,21.2,28239,14113,14126,8795,4312,4483
463,1,9733000,3,26787,1,6299663,01/01/2022,21.1,16934,8502,8432,5395,2626,2769
464,1,9666000,2,56622,1,6226278,01/01/2022,19,11851,5973,5878,3739,1841,1898
465,1,6858000,3,47937,1,4409763,01/01/2022,19.8,25157,12582,12575,8765,4230,4535
466,1,2795000,3,25268,1,1791482,01/01/2022,27.8,6055,3107,2948,1652,803,849
467,1,2225000,3,26845,1,1419405,01/01/2022,19.8,22421,11364,11057,6263,3134,3129
468,1,1624000,3,26712,1,1028888,01/01/2022,21.1,9864,5093,4771,3123,1529,1594
469,1,2736000,3,21247,1,1757153,01/01/2022,22.4,7888,4037,3851,3058,1509,1549
470,1,3438000,3,29464,1,2205236,01/01/2022,20.4,5524,2885,2639,1817,894,923
472,1,2684000,3,28928,1,1715672,01/01/2022,21,10328,5288,5040,3690,1794,1896
473,1,714000,3,2763,1,461337,01/01/2022,22.4,4810,2229,2581,1556,759,797
474,2,62701000,1,149645,2,40606005,01/01/2022,19.2,329404,168547,160857,90108,44605,45503
475,3,109367000,1,289161,3,70799389,01/01/2022,18.6,855563,431621,423942,240318,117646,122672
476,1,23237000,2,76718,1,15027332,01/01/2022,16.9,117253,59414,57839,33098,16300,16798
477,2,45617000,2,72039,2,29579011,01/01/2022,15.3,176685,87738,88947,53884,26504,27380
478,2,46789000,1,137256,2,30275594,01/01/2022,11.7,261137,131158,129979,84004,41439,42565
479,1,27209000,2,55028,1,17630822,01/01/2022,18.1,120926,61958,58968,34805,17098,17707
480,1,17638000,3,37118,1,11427582,01/01/2022,25.1,67604,34141,33463,21101,10330,10771
481,1,10288000,3,28550,1,6658650,01/01/2022,19.1,38886,19733,19153,11641,5731,5910
482,1,10889000,3,26126,1,7051724,01/01/2022,17.4,30324,15540,14784,8298,4088,4210
483,1,17438000,3,41254,1,11293446,01/01/2022,9,91029,45722,45307,30379,15003,15376
484,1,15945000,3,30581,1,10333669,01/01/2022,15.8,62301,30877,31424,20494,10127,10367
485,1,1912000,3,24896,1,1217904,01/01/2022,22.7,12987,6460,6527,4296,2156,2140
486,1,9400000,3,32073,1,6077927,01/01/2022,11.4,38113,19225,18888,12385,6138,6247
487,1,1708000,3,26445,1,1083755,01/01/2022,17.8,12372,6340,6032,3845,1851,1994
488,1,8296000,3,26504,1,5365896,01/01/2022,15.6,39474,19169,20305,14904,7336,7568
489,1,8378000,3,31424,1,5414276,01/01/2022,14.8,30429,15578,14851,9786,4826,4960
490,1,3323000,3,30006,1,2129944,01/01/2022,16.6,13153,6653,6500,4059,2009,2050
491,1,4061000,3,30187,1,2609463,01/01/2022,12.7,11440,5836,5604,4121,2095,2026
492,1,1772000,3,29962,1,1121838,01/01/2022,12.6,4787,2437,2350,1357,684,673
493,2,89530000,1,176775,2,58017725,01/01/2022,22.5,340060,178122,161938,86078,42456,43622
494,2,44133000,3,47469,2,28638981,01/01/2022,23.9,43035,22773,20262,11996,6054,5942
495,1,19472000,3,38344,1,12618456,01/01/2022,24.6,27182,14325,12857,8434,4220,4214
496,1,13873000,3,28457,1,8988993,01/01/2022,23.9,21003,10909,10094,6452,3209,3243
497,1,21036000,3,37398,1,13636002,01/01/2022,24.2,31435,16316,15119,9125,4445,4680
498,1,15886000,2,62705,1,10263195,01/01/2022,23.3,29068,15153,13915,8638,4280,4358
499,1,18526000,3,25854,1,12016046,01/01/2022,22.6,25555,13197,12358,7191,3479,3712
500,1,5767000,3,24577,1,3723973,01/01/2022,23.8,13944,7272,6672,4420,2177,2243
501,1,17728000,3,25305,1,11497895,01/01/2022,24.4,34946,17956,16990,11208,5422,5786
502,1,14089000,3,25354,1,9132496,01/01/2022,23.4,16679,8618,8061,4633,2284,2349
503,2,49218000,2,86683,2,31905017,01/01/2022,19.6,297373,155718,141655,71865,35366,36499
504,3,116295000,1,215046,3,75376704,01/01/2022,14.8,691557,348387,343170,213267,104895,108372
505,2,60265000,2,82980,2,39089270,01/01/2022,14.2,416055,211059,204996,132268,65355,66913
506,1,15224000,3,38283,1,9857317,01/01/2022,15.8,111314,55902,55412,35576,17423,18153
507,2,56976000,2,102327,2,36932073,01/01/2022,17.2,332100,171749,160351,94911,46503,48408
508,1,28229000,3,43271,1,18305579,01/01/2022,19.2,79515,41903,37612,21445,10720,10725
509,1,24470000,2,59874,1,15845626,01/01/2022,19.2,205933,107685,98248,49242,24249,24993
510,1,10424000,3,28652,1,6746948,01/01/2022,15.2,48172,24667,23505,15031,7399,7632
511,1,9036000,3,28058,1,5845342,01/01/2022,15.8,18592,8945,9647,4116,2046,2070
512,1,25431000,3,44544,1,16485606,01/01/2022,19.8,79824,40689,39135,24808,12213,12595
513,1,1847000,3,23322,1,1177228,01/01/2022,15.8,10327,5388,4939,2996,1506,1490
514,1,6410000,3,22056,1,4144444,01/01/2022,15.8,28215,14347,13868,9384,4582,4802
517,1,28908000,3,43106,1,18747094,01/01/2022,10.7,53373,27810,25563,15744,7755,7989
518,2,39195000,2,87082,2,25389668,01/01/2022,14.6,13555,7357,6198,3051,1547,1504
519,2,30563000,3,44347,2,19821603,01/01/2022,11.2,59871,31271,28600,19112,9469,9643
520,2,53114000,2,74452,2,34449648,01/01/2022,13.2,47632,25410,22222,12563,6265,6298
521,1,20126000,3,40511,1,13041389,01/01/2022,13.8,45587,23716,21871,14000,6913,7087
522,1,15994000,3,27795,1,10368305,01/01/2022,11.3,37704,19683,18021,12453,6131,6322
523,1,15588000,3,18091,1,10114109,01/01/2022,10.7,70224,35655,34569,24421,12033,12388
524,1,3537000,3,25596,1,2273454,01/01/2022,10.7,17978,9382,8596,6248,3105,3143
525,1,1714000,3,27369,1,1086731,01/01/2022,10.7,13401,6929,6472,4288,2149,2139
526,1,1489000,3,19873,1,947977,01/01/2022,10.7,30417,15670,14747,9405,4719,4686
527,1,7415000,3,8263,1,4811487,01/01/2022,10.7,28657,14853,13804,9078,4552,4526
528,1,1110000,3,12998,1,708502,01/01/2022,10.7,1583,826,757,480,230,250
529,2,61273000,2,93668,2,39733782,01/01/2022,18.6,139075,74465,64610,36819,18286,18533
530,2,64221000,2,85077,2,41658573,01/01/2022,17.5,120500,65043,55457,29046,14403,14643
531,2,61877000,2,61035,2,40159015,01/01/2022,23,101336,54039,47297,24763,12096,12667
532,3,133453000,1,322930,3,86421520,01/01/2022,23,405952,215818,190134,89205,43880,45325
533,2,52258000,1,111047,2,33856653,01/01/2022,23,212540,111746,100794,51580,25268,26312
534,2,56469000,1,127568,2,36577282,01/01/2022,20.8,180057,96347,83710,45301,22589,22712
535,2,76989000,1,209929,2,49832921,01/01/2022,17.2,443063,237967,205096,110147,54509,55638
536,1,24183000,3,31396,1,15687554,01/01/2022,18.5,33226,17650,15576,10241,5095,5146
537,1,9473000,3,48479,1,6108971,01/01/2022,22.7,15512,8193,7319,4859,2440,2419
538,2,38570000,3,51443,2,25019057,01/01/2022,20.4,64445,34215,30230,17692,8626,9066
539,2,33877000,2,67206,2,21952844,01/01/2022,23.5,48567,25769,22798,13570,6693,6877
540,1,24958000,3,31900,1,16190800,01/01/2022,11.8,42451,22342,20109,14824,7241,7583
541,1,16088000,3,29162,1,10428038,01/01/2022,19.3,41588,21739,19849,12522,6161,6361
543,1,23842000,3,51841,1,15445459,01/01/2022,20.8,55452,29697,25755,14940,7380,7560
544,1,1686000,3,25002,1,1070898,01/01/2022,23,6076,3180,2896,1703,844,859
545,2,43137000,2,64296,2,27974754,01/01/2022,20.8,64692,34002,30690,19678,9778,9900
546,1,2069000,3,27904,1,1316946,01/01/2022,22.4,22760,12125,10635,6420,3229,3191
547,1,15399000,3,39387,1,9969963,01/01/2022,20.6,25608,13480,12128,7723,3870,3853
548,1,10103000,2,59620,1,6507330,01/01/2022,20.4,15733,8506,7227,4079,2054,2025
549,1,8763000,3,26854,1,5669096,01/01/2022,17.5,41785,22480,19305,10854,5445,5409
550,1,9942000,3,42206,1,6420094,01/01/2022,21.6,13225,6946,6279,3476,1669,1807
551,1,14293000,3,38193,1,9252257,01/01/2022,18,28655,15243,13412,8764,4302,4462
552,1,6173000,3,41178,1,3971272,01/01/2022,20.8,17727,9423,8304,4199,2068,2131
553,1,11665000,1,106550,1,7475700,01/01/2022,22.7,8969,4883,4086,2821,1444,1377
554,1,10945000,3,28104,1,7086146,01/01/2022,23.3,16758,8967,7791,4993,2542,2451
555,2,34762000,3,45956,2,22549344,01/01/2022,23.1,47035,25085,21950,12872,6289,6583
556,1,21165000,3,30354,1,13726896,01/01/2022,23,55720,29557,26163,14521,7123,7398
557,1,17601000,3,33745,1,11406905,01/01/2022,20.5,46909,24866,22043,15156,7483,7673
558,1,12739000,3,36520,1,8243830,01/01/2022,20.5,33986,17827,16159,9043,4421,4622
559,1,16481000,3,26249,1,10686401,01/01/2022,17.5,34847,18666,16181,8943,4380,4563
560,1,14827000,3,39883,1,9597667,01/01/2022,22.5,14304,7545,6759,4455,2182,2273
561,1,9153000,3,25704,1,5923746,01/01/2022,26.7,20797,10995,9802,4991,2418,2573
562,1,17445000,3,26246,1,11313004,01/01/2022,22.4,30232,15727,14505,8913,4281,4632
563,1,25922000,2,82585,1,16766715,01/01/2022,22.1,20165,10621,9544,5395,2701,2694
564,1,2734000,3,23008,1,1754092,01/01/2022,20.8,20380,10692,9688,6259,3127,3132
565,1,12238000,3,25404,1,7929296,01/01/2022,11.2,21640,11976,9664,7433,3885,3548
566,1,24380000,3,35605,1,15811395,01/01/2022,13.3,33402,17876,15526,9753,4761,4992
567,1,20977000,3,49134,1,13585916,01/01/2022,19.3,26236,13620,12616,8067,3962,4105
568,1,2697000,3,46777,1,1706273,01/01/2022,23.1,4405,2358,2047,1451,735,716
569,1,3323000,3,29740,1,2130210,01/01/2022,21.4,13716,7109,6607,3981,1920,2061
570,1,12641000,3,27396,1,8189254,01/01/2022,22.5,5653,2987,2666,1709,826,883
571,1,8757000,3,31399,1,5660651,01/01/2022,22.2,21318,11472,9846,5688,2873,2815
572,1,11214000,3,28413,1,7260687,01/01/2022,22.5,14582,7621,6961,4539,2262,2277
573,1,1447000,3,34047,1,906503,01/01/2022,27.8,6219,3311,2908,1883,941,942
574,1,8981000,3,37644,1,5800006,01/01/2022,23.5,31856,17018,14838,8563,4318,4245
575,1,17294000,3,26803,1,11214297,01/01/2022,17.5,35893,18883,17010,11399,5600,5799
576,1,15592000,3,29856,1,10104944,01/01/2022,22.2,19272,10328,8944,5163,2534,2629
577,1,18104000,3,30548,1,11737052,01/01/2022,11.1,16364,8711,7653,5250,2654,2596
578,1,10555000,3,28081,1,6832669,01/01/2022,23,2820,1449,1371,720,341,379
579,1,1862000,3,27507,1,1182793,01/01/2022,23.2,4654,2510,2144,1296,630,666
580,1,1499000,3,26395,1,947955,01/01/2022,11.1,21585,11243,10342,6456,3197,3259
581,1,1497000,3,29341,1,943709,01/01/2022,22.5,6888,3543,3345,1840,922,918
582,1,1720000,3,27835,1,1090165,01/01/2022,21.5,21391,11404,9987,5619,2742,2877
583,1,1292000,3,26595,1,813205,01/01/2022,22.4,9668,5030,4638,2384,1141,1243
584,1,16069000,3,27253,1,10417597,01/01/2022,23.5,13995,7311,6684,4212,2070,2142
585,1,4053000,3,27144,1,2607306,01/01/2022,23,6838,3583,3255,1791,891,900
586,1,1394000,3,27295,1,878805,01/01/2022,21.5,5681,3058,2623,1606,823,783
587,1,9166000,3,27403,1,5930497,01/01/2022,11.1,13966,7679,6287,3739,1859,1880
588,1,11821000,3,18491,1,7665159,01/01/2022,22.8,28076,14773,13303,7550,3752,3798
589,1,5936000,3,26396,1,3832004,01/01/2022,10.6,34039,18008,16031,8858,4334,4524
590,1,2082000,3,22238,1,1331062,01/01/2022,17.5,15807,8231,7576,5949,2955,2994
591,1,1322000,3,15168,1,844132,01/01/2022,23,10581,5508,5073,2907,1418,1489
592,1,3874000,3,26104,1,2491996,01/01/2022,15.3,9554,4935,4619,2707,1302,1405
593,1,13534000,2,56478,1,8740622,01/01/2022,20.5,9988,5342,4646,2237,1127,1110
594,1,2182000,3,15768,1,1402532,01/01/2022,21.5,7578,3984,3594,2088,1031,1057
595,1,2191000,3,46372,1,1377778,01/01/2022,16.2,8005,4106,3899,2599,1296,1303
596,1,2510000,3,24412,1,1607088,01/01/2022,22.8,24085,12288,11797,7909,3780,4129
597,1,3081000,3,25254,1,1977396,01/01/2022,21.5,7455,4054,3401,2223,1145,1078
598,1,788000,3,9891,1,502309,01/01/2022,24.1,17919,9538,8381,4548,2298,2250
600,3,120006000,1,302717,3,77701183,01/01/2022,24,921771,479309,442462,222551,109790,112761
601,1,11175000,3,26987,1,7236763,01/01/2022,20.6,26081,13338,12743,7626,3791,3835
602,1,25468000,3,26324,1,16527876,01/01/2022,24.3,56494,29131,27363,17460,8617,8843
603,1,15713000,3,31097,1,10182353,01/01/2022,22.3,52593,26982,25611,16883,8307,8576
604,1,4625000,3,34957,1,2971293,01/01/2022,23.3,41965,21110,20855,11192,5453,5739
605,1,7508000,3,32031,1,4848169,01/01/2022,23,26175,13553,12622,8885,4301,4584
606,1,10239000,3,27945,1,6627405,01/01/2022,22.1,35183,17868,17315,10650,5230,5420
607,1,8279000,3,27253,1,5354097,01/01/2022,21.3,56409,28489,27920,16919,8292,8627
608,1,7178000,3,12337,1,4653363,01/01/2022,22.8,139753,70456,69297,45077,22298,22779
609,1,5376000,3,26337,1,3468063,01/01/2022,23,17841,9042,8799,5372,2677,2695
610,1,6982000,3,20666,1,4517634,01/01/2022,22.8,28461,14574,13887,9148,4533,4615
611,2,31351000,2,68573,2,20309577,01/01/2022,14,143281,73905,69376,47529,23519,24010
612,2,35759000,1,111989,2,23131361,01/01/2022,12.2,138444,72335,66109,38201,18773,19428
613,1,11026000,3,25538,1,7141362,01/01/2022,13.6,22295,11690,10605,8176,4115,4061
614,1,12063000,2,55284,1,7785666,01/01/2022,12.6,25068,12776,12292,8673,4237,4436
615,1,3003000,3,29464,1,1922486,01/01/2022,14.4,15291,7886,7405,5051,2477,2574
616,1,4348000,3,27113,1,2799087,01/01/2022,12.7,38193,19467,18726,13775,6896,6879
617,1,9577000,3,30156,1,6194894,01/01/2022,14.6,46132,23831,22301,13972,6871,7101
618,1,1861000,3,24763,1,1184887,01/01/2022,18.7,13641,7027,6614,4307,2133,2174
